     45 Sámi	Sámi	___	___
     22 Kon	Kon	___	___
     22 Akwé	Akwé	___	___
     21 Sápmi	Sápmi	___	___
     20 Duodji	Duodji	___	___
     18 čoonnâs	čoonnâs	___	___
     17 čuákkimistis	čuákkimistis	___	___
     14 at	at	___	___
     13 puátusin	puátusin	___	___
     13 olmoošvuoigâdvuođâpoolitlâš	olmoošvuoigâdvuođâpoolitlâš	___	___
     13 fi	fi	___	___
     12 samediggi	samediggi	___	___
     12 kieđâvušeh	kieđâvušeh	___	___
     12 Miessi	Miessi	___	___
     12 Briceđo	Briceđo	___	___
     11 algâaalmugjulgáštuš	algâaalmugjulgáštuš	___	___
     10 äässih	äässih	___	___
     10 Juvá	Juvá	___	___
      9 toohum	toohum	___	___
      9 tiäddut	tiäddut	___	___
      9 ry.	ry.	___	___
      9 rastaldittee	rastaldittee	___	___
      9 parlamiänttárij	parlamiänttárij	___	___
      9 on	on	___	___
      9 Ijâttis	Ijâttis	___	___
      8 čáitálmâs	čáitálmâs	___	___
      8 vátávâšvuodâtääsi	vátávâšvuodâtääsi	___	___
      8 visásmiteh	visásmiteh	___	___
      8 oovtmielâlávt	oovtmielâlávt	___	___
      8 nuorttâlâšâi	nuorttâlâšâi	___	___
      8 interneetist	interneetist	___	___
      8 biodiversiteettisopâmuš	biodiversiteettisopâmuš	___	___
      8 atk-tááiđuh	atk-tááiđuh	___	___
      8 Records	Records	___	___
      8 Mondest	Mondest	___	___
      8 Binna	Binna	___	___
      7 Čáitálmâs	Čáitálmâs	___	___
      7 musikkist	musikkist	___	___
      7 musijkkár	musijkkár	___	___
      7 lääččih	lääččih	___	___
      7 allaskuvla	allaskuvla	___	___
      7 Násti	Násti	___	___
      7 Milla	Milla	___	___
      7 Akwé:Kon	Akwé:Kon	___	___
      7 Adjágas	Adjágas	___	___
      6 tábáhtusan	tábáhtusan	___	___
      6 tuđâvâžžân	tuđâvâžžân	___	___
      6 tuávváá	tuávváá	___	___
      6 tah	tah	___	___
      6 stk	stk	___	___
      6 ruukitooimâ	ruukitooimâ	___	___
      6 rastâldittee	rastâldittee	___	___
      6 merhâšitteht	merhâšitteht	___	___
      6 konfereensân	konfereensân	___	___
      6 kandidaat	kandidaat	___	___
      6 historjállâš	historjállâš	___	___
      6 finnimnáál	finnimnáál	___	___
      6 SáFá	SáFá	___	___
      6 PaKaste	PaKaste	___	___
      6 Ensemble	Ensemble	___	___
      5 čovgâ	čovgâ	___	___
      5 äägi	äägi	___	___
      5 väljejuvvii	väljejuvvii	___	___
      5 vátávâšvuodâtaasij	vátávâšvuodâtaasij	___	___
      5 vuotânväldim	vuotânväldim	___	___
      5 uážžost	uážžost	___	___
      5 uappeid	uappeid	___	___
      5 sämikielâlâlij	sämikielâlâlij	___	___
      5 sj	sj	___	___
      5 ruotâ-	ruotâ-	___	___
      5 rock	rock	___	___
      5 resurssistem	resurssistem	___	___
      5 resurssijd	resurssijd	___	___
      5 prinsiipâid	prinsiipâid	___	___
      5 oovtmielâliih	oovtmielâliih	___	___
      5 naanood	naanood	___	___
      5 munemietâmâš	munemietâmâš	___	___
      5 luokittâllâm	luokittâllâm	___	___
      5 live	live	___	___
      5 kirjejum	kirjejum	___	___
      5 kielâpalhaâšume	kielâpalhaâšume	___	___
      5 jotonpieijâm	jotonpieijâm	___	___
      5 j):n	j):n	___	___
      5 heivitmist	heivitmist	___	___
      5 delegaatio	delegaatio	___	___
      5 aula	aula	___	___
      5 The	The	___	___
      5 Solju	Solju	___	___
      5 Kena	Kena	___	___
      4 čáitáldâs	čáitáldâs	___	___
      4 ČUÁKKIMVISTE	ČUÁKKIMVISTE	___	___
      4 áigá	áigá	___	___
      4 Ánnámáret	Ánnámáret	___	___
      4 velttidhánnáá	velttidhánnáá	___	___
      4 vastaan	vastaan	___	___
      4 valmâštellee	valmâštellee	___	___
      4 uásálistemvuođâ	uásálistemvuođâ	___	___
      4 uaivildum	uaivildum	___	___
      4 tuáivuttettee	tuáivuttettee	___	___
      4 taaidâtábátusân	taaidâtábátusân	___	___
      4 taaidâreh	taaidâreh	___	___
      4 sämiparlamiänttárij	sämiparlamiänttárij	___	___
      4 sähköpostiosoite	sähköpostiosoite	___	___
      4 suojattu	suojattu	___	___
      4 ruukilaavâ	ruukilaavâ	___	___
      4 roskapostia	roskapostia	___	___
      4 resurssijguin	resurssijguin	___	___
      4 resurssij	resurssij	___	___
      4 päälle	päälle	___	___
      4 prosessist	prosessist	___	___
      4 projekt	projekt	___	___
      4 olášuumán	olášuumán	___	___
      4 olášuttâm	olášuttâm	___	___
      4 olmoošvuoigâdvuođâváldálii	olmoošvuoigâdvuođâváldálii	___	___
      4 olmoošvuoigâdvuođâpolitiikâst	olmoošvuoigâdvuođâpolitiikâst	___	___
      4 oleslâžžân	oleslâžžân	___	___
      4 nähdäksesi	nähdäksesi	___	___
      4 nubástittem	nubástittem	___	___
      4 máttáátâs	máttáátâs	___	___
      4 movtijditeh	movtijditeh	___	___
      4 luvâldelleid	luvâldelleid	___	___
      4 leuŠdd	leuŠdd	___	___
      4 lain	lain	___	___
      4 kuávdážist	kuávdážist	___	___
      4 konfereensâst	konfereensâst	___	___
      4 kenigit	kenigit	___	___
      4 juulev-	juulev-	___	___
      4 julgáštusâi	julgáštusâi	___	___
      4 javascripttuki	javascripttuki	___	___
      4 hiäđukocceem	hiäđukocceem	___	___
      4 fálusist	fálusist	___	___
      4 eenikiellânis	eenikiellânis	___	___
      4 aseta	aseta	___	___
      4 anâraškielâ	anâraškielâ	___	___
      4 and	and	___	___
      4 almostiteh	almostiteh	___	___
      4 Tämä	Tämä	___	___
      4 Tábáhtusan	Tábáhtusan	___	___
      4 Thors	Thors	___	___
      4 Sämiparlamiänttárij	Sämiparlamiänttárij	___	___
      4 Projektčällee	Projektčällee	___	___
      4 Olmoošvuoigâdvuođâpoolitlâš	Olmoošvuoigâdvuođâpoolitlâš	___	___
      4 Oktavuohta	Oktavuohta	___	___
      4 Martta	Martta	___	___
      4 Maaŋgâtooimâsali	Maaŋgâtooimâsali	___	___
      4 Laaiti	Laaiti	___	___
      4 Kokoomus	Kokoomus	___	___
      4 Johtti	Johtti	___	___
      4 Dollast	Dollast	___	___
      4 Dolla	Dolla	___	___
      4 Anára	Anára	___	___
      4 Aldamáttááttâs	Aldamáttááttâs	___	___
      3 		___	___
      3 škovlimpoolitlâš	škovlimpoolitlâš	___	___
      3 ŠSäämi	ŠSäämi	___	___
      3 čuákánpieijâm	čuákánpieijâm	___	___
      3 čižetbeln	čižetbeln	___	___
      3 Čáitáldâs	Čáitáldâs	___	___
      3 Čagaldahttit	Čagaldahttit	___	___
      3 ášástâldijn	ášástâldijn	___	___
      3 árvuštâllâmnáál	árvuštâllâmnáál	___	___
      3 Äššigâšrävvejeijee	Äššigâšrävvejeijee	___	___
      3 vátávâšvuođâtââsi	vátávâšvuođâtââsi	___	___
      3 vuáđuStâSah	vuáđuStâSah	___	___
      3 vuotânväldimist	vuotânväldimist	___	___
      3 vp	vp	___	___
      3 virgeomâhijd	virgeomâhijd	___	___
      3 valmâštellen	valmâštellen	___	___
      3 uhkevuálážij	uhkevuálážij	___	___
      3 táál	táál	___	___
      3 táru-	táru-	___	___
      3 tiäđujotteem	tiäđujotteem	___	___
      3 tiäduttuvá	tiäduttuvá	___	___
      3 sämmilâšašijn	sämmilâšašijn	___	___
      3 sämimáccuhist	sämimáccuhist	___	___
      3 sujâttemnáál	sujâttemnáál	___	___
      3 staatâvarijváljukode	staatâvarijváljukode	___	___
      3 sorjájeijee	sorjájeijee	___	___
      3 sajâttuv	sajâttuv	___	___
      3 ráđádellee	ráđádellee	___	___
      3 resurssistmân	resurssistmân	___	___
      3 ratifistiđ	ratifistiđ	___	___
      3 ratifisistemprosessist	ratifisistemprosessist	___	___
      3 rasism	rasism	___	___
      3 pääccih	pääccih	___	___
      3 pygálusâin	pygálusâin	___	___
      3 puávtâččij	puávtâččij	___	___
      3 proojektkoordinaattor	proojektkoordinaattor	___	___
      3 prinsiipâi	prinsiipâi	___	___
      3 prinsiipah	prinsiipah	___	___
      3 presideentâi	presideentâi	___	___
      3 presideentah	presideentah	___	___
      3 peivikiäijoid	peivikiäijoid	___	___
      3 parlamenttârij	parlamenttârij	___	___
      3 ovdedm	ovdedm	___	___
      3 onnáápeeivi	onnáápeeivi	___	___
      3 olmoošvuoigâdvuođâváldálâš	olmoošvuoigâdvuođâváldálâš	___	___
      3 olesmiärálávt	olesmiärálávt	___	___
      3 of	of	___	___
      3 nettičujottâsât	nettičujottâsât	___	___
      3 muuštâč	muuštâč	___	___
      3 muusikkân	muusikkân	___	___
      3 musikkân	musikkân	___	___
      3 musijkkárid	musijkkárid	___	___
      3 mom	mom	___	___
      3 miäruštâlluvvojeh	miäruštâlluvvojeh	___	___
      3 mittomeerin	mittomeerin	___	___
      3 mielânpäccee	mielânpäccee	___	___
      3 mieldiluhâmáin	mieldiluhâmáin	___	___
      3 meahci	meahci	___	___
      3 maaŋgâtoimâ-	maaŋgâtoimâ-	___	___
      3 maaŋgâsuárgásiih	maaŋgâsuárgásiih	___	___
      3 lávdásteleh	lávdásteleh	___	___
      3 loppâpuátusin	loppâpuátusin	___	___
      3 kieđâvuššâmnáál	kieđâvuššâmnáál	___	___
      3 kielâašijčällee	kielâašijčällee	___	___
      3 kevttinvuávám	kevttinvuávám	___	___
      3 kevttimnáálá	kevttimnáálá	___	___
      3 kevttimnáál	kevttimnáál	___	___
      3 keha	keha	___	___
      3 juávku	juávku	___	___
      3 juávkkupargotilen	juávkkupargotilen	___	___
      3 ikkunassa	ikkunassa	___	___
      3 heivitmân	heivitmân	___	___
      3 haldâttâsneuvos	haldâttâsneuvos	___	___
      3 haaldâšlâš	haaldâšlâš	___	___
      3 eromâšavt	eromâšavt	___	___
      3 epiohtâlii	epiohtâlii	___	___
      3 delegaatiost	delegaatiost	___	___
      3 delegaatioin	delegaatioin	___	___
      3 delegaatioid	delegaatioid	___	___
      3 ađa	ađa	___	___
      3 arkkitehtuurkištodem	arkkitehtuurkištodem	___	___
      3 ambassaadâ	ambassaadâ	___	___
      3 algâaamugij	algâaamugij	___	___
      3 aabbis	aabbis	___	___
      3 _	_	___	___
      3 Valtioneuvosto	Valtioneuvosto	___	___
      3 VUOTÂNVÄLDIM	VUOTÂNVÄLDIM	___	___
      3 Uumeest	Uumeest	___	___
      3 TEKNIIK	TEKNIIK	___	___
      3 Sápmin	Sápmin	___	___
      3 Sámisearvi	Sámisearvi	___	___
      3 SÄÄMI	SÄÄMI	___	___
      3 Syennjilsiijdâ	Syennjilsiijdâ	___	___
      3 Sounds	Sounds	___	___
      3 Soster	Soster	___	___
      3 Siäđusmiäldásii	Siäđusmiäldásii	___	___
      3 Seenaat-kidânjâsah	Seenaat-kidânjâsah	___	___
      3 Riskuna	Riskuna	___	___
      3 POLURA	POLURA	___	___
      3 PIERGÂSEH	PIERGÂSEH	___	___
      3 Oovtâstpargokyeimmin	Oovtâstpargokyeimmin	___	___
      3 Olmoošvuoigâdvuotváldálâš	Olmoošvuoigâdvuotváldálâš	___	___
      3 Oahppoofelaš-haavâ	Oahppoofelaš-haavâ	___	___
      3 Nuorra	Nuorra	___	___
      3 Min	Min	___	___
      3 Mattson	Mattson	___	___
      3 Lyseonpuisto	Lyseonpuisto	___	___
      3 Lostâdâhtavlu	Lostâdâhtavlu	___	___
      3 Liiŋkih	Liiŋkih	___	___
      3 LASEMÁÁVSUST	LASEMÁÁVSUST	___	___
      3 Helse	Helse	___	___
      3 Heinäluoma	Heinäluoma	___	___
      3 Eteläesplanadi	Eteläesplanadi	___	___
      3 Eloa	Eloa	___	___
      3 Beaivvi	Beaivvi	___	___
      3 Banca	Banca	___	___
      3 1711,31eurod/mp	1711,31eurod/mp	___	___
      2 Škovlim-já	Škovlim-já	___	___
      2 čáácá	čáácá	___	___
      2 čuávvoonáál	čuávvoonáál	___	___
      2 čuávvoht	čuávvoht	___	___
      2 čuákkimorniimij	čuákkimorniimij	___	___
      2 čulhoost	čulhoost	___	___
      2 čoođâmanneeh	čoođâmanneeh	___	___
      2 čoonnâsmáin	čoonnâsmáin	___	___
      2 čonâdâteh	čonâdâteh	___	___
      2 čierru	čierru	___	___
      2 čiegát	čiegát	___	___
      2 čeepiht	čeepiht	___	___
      2 čalmeestanettettee	čalmeestanettettee	___	___
      2 Čagaldahttin	Čagaldahttin	___	___
      2 äššitobdeevuođâ	äššitobdeevuođâ	___	___
      2 äššitobdeemekanism	äššitobdeemekanism	___	___
      2 äššigâšpalvâlem	äššigâšpalvâlem	___	___
      2 ääšioovdânpyehteepargoh	ääšioovdânpyehteepargoh	___	___
      2 äigitavlust	äigitavlust	___	___
      2 áššigâš	áššigâš	___	___
      2 ávhástâleh	ávhástâleh	___	___
      2 ávhástâldijn	ávhástâldijn	___	___
      2 árvuštâllâmprosessist	árvuštâllâmprosessist	___	___
      2 árvuštem	árvuštem	___	___
      2 áhkubat	áhkubat	___	___
      2 Äššigâš	Äššigâš	___	___
      2 Áppes	Áppes	___	___
      2 Álas	Álas	___	___
      2 ¨palvâlusâi	¨palvâlusâi	___	___
      2 ¨kuávdáá	¨kuávdáá	___	___
      2 webropol-koijâdâllâm	webropol-koijâdâllâm	___	___
      2 väättih	väättih	___	___
      2 västidijee	västidijee	___	___
      2 väridemnáál	väridemnáál	___	___
      2 válduđ	válduđ	___	___
      2 váldulávdástellen	váldulávdástellen	___	___
      2 vyelinummeer	vyelinummeer	___	___
      2 vyeleebtásásii	vyeleebtásásii	___	___
      2 vyebdimnáál	vyebdimnáál	___	___
      2 vuáđulavâlâš	vuáđulavâlâš	___	___
      2 vuáđudemprojekt	vuáđudemprojekt	___	___
      2 vuáháduumán	vuáháduumán	___	___
      2 vuotânväldee	vuotânväldee	___	___
      2 vuoigâtvuođâid	vuoigâtvuođâid	___	___
      2 vuoi-gâdvuođâid	vuoi-gâdvuođâid	___	___
      2 vsj	vsj	___	___
      2 vistádâh	vistádâh	___	___
      2 vistáduv	vistáduv	___	___
      2 virgeomâhijn	virgeomâhijn	___	___
      2 virgeomâhijguin	virgeomâhijguin	___	___
      2 virgeomâheh	virgeomâheh	___	___
      2 viljâžijd	viljâžijd	___	___
      2 viljâžij	viljâžij	___	___
      2 vijđesvuáđusâš	vijđesvuáđusâš	___	___
      2 viiđi	viiđi	___	___
      2 valmâštâleh	valmâštâleh	___	___
      2 valmâstâllâmnáál	valmâstâllâmnáál	___	___
      2 vaikuttemvuođâ	vaikuttemvuođâ	___	___
      2 vaikuttemvuotâ	vaikuttemvuotâ	___	___
      2 uđâsmittâm	uđâsmittâm	___	___
      2 uážžon	uážžon	___	___
      2 uápásteijen	uápásteijen	___	___
      2 uáinusistorroom	uáinusistorroom	___	___
      2 uuccâmnáálá	uuccâmnáálá	___	___
      2 uhkevulážij	uhkevulážij	___	___
      2 ucessiähá	ucessiähá	___	___
      2 uccui	uccui	___	___
      2 uasild	uasild	___	___
      2 täi	täi	___	___
      2 táássážân	táássážân	___	___
      2 táárbumield	táárbumield	___	___
      2 táárboid	táárboid	___	___
      2 táálást	táálást	___	___
      2 tábáhtusorniimijn	tábáhtusorniimijn	___	___
      2 tuáivumield	tuáivumield	___	___
      2 tohálâšvuođâvátámâžžân	tohálâšvuođâvátámâžžân	___	___
      2 tobdosumos	tobdosumos	___	___
      2 to	to	___	___
      2 tiäđulonottem	tiäđulonottem	___	___
      2 tiäduttuveh	tiäduttuveh	___	___
      2 the	the	___	___
      2 taatâ	taatâ	___	___
      2 taaidârij	taaidârij	___	___
      2 taaid	taaid	___	___
      2 sämmilâškirjimij	sämmilâškirjimij	___	___
      2 sämituáimeid	sämituáimeid	___	___
      2 sämitiggij	sämitiggij	___	___
      2 sämitaaidâreh	sämitaaidâreh	___	___
      2 sämipolitiikâst	sämipolitiikâst	___	___
      2 sämimáccuhijguin	sämimáccuhijguin	___	___
      2 sämikieltáiđusâš	sämikieltáiđusâš	___	___
      2 sámmiláid	sámmiláid	___	___
      2 suunnâttâllâđ	suunnâttâllâđ	___	___
      2 sulâstiteh	sulâstiteh	___	___
      2 sui	sui	___	___
      2 stream-vuolgâttâssân	stream-vuolgâttâssân	___	___
      2 stream	stream	___	___
      2 stattáid	stattáid	___	___
      2 sriivrâ	sriivrâ	___	___
      2 skiärruid	skiärruid	___	___
      2 sistetuállee	sistetuállee	___	___
      2 sehâ	sehâ	___	___
      2 sarvah	sarvah	___	___
      2 samiska	samiska	___	___
      2 räp	räp	___	___
      2 ráppáá	ráppáá	___	___
      2 ruukij	ruukij	___	___
      2 rokkájeijee	rokkájeijee	___	___
      2 rock-muusik	rock-muusik	___	___
      2 resussistem	resussistem	___	___
      2 resurssáid	resurssáid	___	___
      2 resursseh	resursseh	___	___
      2 ratifistem	ratifistem	___	___
      2 ratifisistâm	ratifisistâm	___	___
      2 ratifisistáččij	ratifisistáččij	___	___
      2 ratifisistá	ratifisistá	___	___
      2 ratifisisteđ	ratifisisteđ	___	___
      2 rastaldittiđ	rastaldittiđ	___	___
      2 raportistis	raportistis	___	___
      2 rap-musijkkár	rap-musijkkár	___	___
      2 páássâm	páássâm	___	___
      2 párgopáájái	párgopáájái	___	___
      2 pálkkámvuáháduv	pálkkámvuáháduv	___	___
      2 puávtâččii	puávtâččii	___	___
      2 puávtá	puávtá	___	___
      2 puásuivyejim	puásuivyejim	___	___
      2 pu	pu	___	___
      2 projektčällee	projektčällee	___	___
      2 projekthovdâ	projekthovdâ	___	___
      2 politiikâst	politiikâst	___	___
      2 pisovâžžân	pisovâžžân	___	___
      2 pisovijd	pisovijd	___	___
      2 pirâslijd	pirâslijd	___	___
      2 pietittis	pietittis	___	___
      2 persovlâš	persovlâš	___	___
      2 parlamentist	parlamentist	___	___
      2 parlameentah	parlameentah	___	___
      2 palhâšumeuážžoid	palhâšumeuážžoid	___	___
      2 ovtâskâsčuággásijd	ovtâskâsčuággásijd	___	___
      2 ovtâskâsčuággásiih	ovtâskâsčuággásiih	___	___
      2 ovedem	ovedem	___	___
      2 ovdâsteijeevâš	ovdâsteijeevâš	___	___
      2 ovdeed	ovdeed	___	___
      2 ovdedemrááhtus-proojeekt	ovdedemrááhtus-proojeekt	___	___
      2 ovdedemrááhtus-	ovdedemrááhtus-	___	___
      2 orniimijn	orniimijn	___	___
      2 ornamentlágán	ornamentlágán	___	___
      2 oppâmateriaaltoimâttah	oppâmateriaaltoimâttah	___	___
      2 oovtkiärdásâžžân	oovtkiärdásâžžân	___	___
      2 onnig	onnig	___	___
      2 olášutteđ	olášutteđ	___	___
      2 oláttâsmeeri	oláttâsmeeri	___	___
      2 olmoošvuoigâdvuođâpolitiikâstis	olmoošvuoigâdvuođâpolitiikâstis	___	___
      2 olmoošvuogâdvuođâpoolitlâš	olmoošvuogâdvuođâpoolitlâš	___	___
      2 olesváládlâš	olesváládlâš	___	___
      2 ofelâššáin	ofelâššáin	___	___
      2 ofelâš	ofelâš	___	___
      2 oainnát	oainnát	___	___
      2 nuorttâlâšâin	nuorttâlâšâin	___	___
      2 nubástutteđ	nubástutteđ	___	___
      2 normim	normim	___	___
      2 njyebžilittiđ	njyebžilittiđ	___	___
      2 niäljâd	niäljâd	___	___
      2 neeljinummeersâš	neeljinummeersâš	___	___
      2 nanosmuvá	nanosmuvá	___	___
      2 nahčâ	nahčâ	___	___
      2 máttáátâskuávdáš	máttáátâskuávdáš	___	___
      2 máttáátâskuávdáá	máttáátâskuávdáá	___	___
      2 máttááttâsvuámij	máttááttâsvuámij	___	___
      2 máttááttâsneuvos	máttááttâsneuvos	___	___
      2 májemustáá	májemustáá	___	___
      2 máidnasat	máidnasat	___	___
      2 máhđulâžžântohâmist	máhđulâžžântohâmist	___	___
      2 muusikfestivaalâ	muusikfestivaalâ	___	___
      2 moilanen	moilanen	___	___
      2 mietâmâšâttáá	mietâmâšâttáá	___	___
      2 meritiätuláin	meritiätuláin	___	___
      2 meccisäsertifistemkriteerin	meccisäsertifistemkriteerin	___	___
      2 maŋŋgah	maŋŋgah	___	___
      2 matriaalâttâs	matriaalâttâs	___	___
      2 materaallii	materaallii	___	___
      2 man	man	___	___
      2 majemuštáá	majemuštáá	___	___
      2 magga	magga	___	___
      2 maaŋgâtooimâsajeh	maaŋgâtooimâsajeh	___	___
      2 maaŋgâpiälásáin	maaŋgâpiälásáin	___	___
      2 maaŋgáin	maaŋgáin	___	___
      2 maallijd	maallijd	___	___
      2 láávdást	láávdást	___	___
      2 lávtástâllâmvuáttámušâid	lávtástâllâmvuáttámušâid	___	___
      2 lávluid	lávluid	___	___
      2 lávdástâlâi	lávdástâlâi	___	___
      2 lávdástâl	lávdástâl	___	___
      2 lávdástii	lávdástii	___	___
      2 luuhâmnáál	luuhâmnáál	___	___
      2 luokittâllum	luokittâllum	___	___
      2 loppâraportistis	loppâraportistis	___	___
      2 loppâbeln	loppâbeln	___	___
      2 lonâttâm	lonâttâm	___	___
      2 lohtâsává	lohtâsává	___	___
      2 lohtâseh	lohtâseh	___	___
      2 lohtâs	lohtâs	___	___
      2 logistiik-	logistiik-	___	___
      2 live-editistemtile	live-editistemtile	___	___
      2 linjâžân	linjâžân	___	___
      2 linjiimáid	linjiimáid	___	___
      2 linjiimijguin	linjiimijguin	___	___
      2 laiguuttemnáál	laiguuttemnáál	___	___
      2 kááđukován	kááđukován	___	___
      2 kárván	kárván	___	___
      2 kárttáá	kárttáá	___	___
      2 kyevti-	kyevti-	___	___
      2 kuáškánjâsah	kuáškánjâsah	___	___
      2 kuovdâkiäinulâš	kuovdâkiäinulâš	___	___
      2 kulttuurpoolitlâš	kulttuurpoolitlâš	___	___
      2 kulttuurpoolitlii	kulttuurpoolitlii	___	___
      2 kulttuurjiešhaldâšemes	kulttuurjiešhaldâšemes	___	___
      2 kulluuvâšvuođâ	kulluuvâšvuođâ	___	___
      2 kuháskyeddee	kuháskyeddee	___	___
      2 kufittárij	kufittárij	___	___
      2 kriteerijd	kriteerijd	___	___
      2 kriteereh	kriteereh	___	___
      2 koordinaatiočuákkimijn	koordinaatiočuákkimijn	___	___
      2 koolgâp	koolgâp	___	___
      2 konserttáin	konserttáin	___	___
      2 kolgâččijm	kolgâččijm	___	___
      2 kirjekooverttâst	kirjekooverttâst	___	___
      2 kirjejuđ	kirjejuđ	___	___
      2 kirjejuuččii	kirjejuuččii	___	___
      2 kijttosavâstis	kijttosavâstis	___	___
      2 kannatteijeevuotâ	kannatteijeevuotâ	___	___
      2 kaisa	kaisa	___	___
      2 kaavpuh	kaavpuh	___	___
      2 ka	ka	___	___
      2 jyehi-ihásâš	jyehi-ihásâš	___	___
      2 juávhoinis	juávhoinis	___	___
      2 juohijn	juohijn	___	___
      2 jođettâsâst	jođettâsâst	___	___
      2 jotonpiejâmân	jotonpiejâmân	___	___
      2 jotonpiejâmist	jotonpiejâmist	___	___
      2 jotonpieijum	jotonpieijum	___	___
      2 jotkâšume	jotkâšume	___	___
      2 jorrá	jorrá	___	___
      2 jieškuástádlâš	jieškuástádlâš	___	___
      2 jiešiävtulávt	jiešiävtulávt	___	___
      2 jieŋŋâlis	jieŋŋâlis	___	___
      2 jiehke	jiehke	___	___
      2 jiecânâs	jiecânâs	___	___
      2 iävtuttâš	iävtuttâš	___	___
      2 iävtun	iävtun	___	___
      2 iäláttâsâsâin	iäláttâsâsâin	___	___
      2 ivijmield	ivijmield	___	___
      2 irmeli	irmeli	___	___
      2 internationaalâst	internationaalâst	___	___
      2 innovatiivlâš	innovatiivlâš	___	___
      2 infočuágástuv	infočuágástuv	___	___
      2 iivneh	iivneh	___	___
      2 hálddašanguovlu	hálddašanguovlu	___	___
      2 horisontaallávt	horisontaallávt	___	___
      2 holistilii	holistilii	___	___
      2 hoittám-‐	hoittám-‐	___	___
      2 hiäđub	hiäđub	___	___
      2 historjállijn	historjállijn	___	___
      2 herbaario	herbaario	___	___
      2 heeitugin	heeitugin	___	___
      2 guovvamánoija	guovvamánoija	___	___
      2 fäällih	fäällih	___	___
      2 fáárunluhâmáin	fáárunluhâmáin	___	___
      2 fastân	fastân	___	___
      2 fasta	fasta	___	___
      2 faksânummeer	faksânummeer	___	___
      2 eŋgalâskielâ	eŋgalâskielâ	___	___
      2 europarlamiänttár	europarlamiänttár	___	___
      2 että	että	___	___
      2 ettâmnáál	ettâmnáál	___	___
      2 epke	epke	___	___
      2 energiapoolitlâš	energiapoolitlâš	___	___
      2 energiapolitiijkâst	energiapolitiijkâst	___	___
      2 eennâkevttimist	eennâkevttimist	___	___
      2 eeni-kielân	eeni-kielân	___	___
      2 eana	eana	___	___
      2 duo	duo	___	___
      2 draamaatlâš	draamaatlâš	___	___
      2 deebyytalbumis	deebyytalbumis	___	___
      2 bruttovijđodâh	bruttovijđodâh	___	___
      2 borrá	borrá	___	___
      2 aulast	aulast	___	___
      2 assosiaatioid	assosiaatioid	___	___
      2 artikkâlâi	artikkâlâi	___	___
      2 arkkitehtuurlâš	arkkitehtuurlâš	___	___
      2 arkkitehtuurkištottâllâm	arkkitehtuurkištottâllâm	___	___
      2 arkkitehtuurkišto	arkkitehtuurkišto	___	___
      2 arkkit	arkkit	___	___
      2 anu	anu	___	___
      2 ansulii	ansulii	___	___
      2 alnetoollâđ	alnetoollâđ	___	___
      2 almostittâm	almostittâm	___	___
      2 almostittán	almostittán	___	___
      2 algâsâš	algâsâš	___	___
      2 aldamáttááttâspaje	aldamáttááttâspaje	___	___
      2 addeelmâš	addeelmâš	___	___
      2 Yliriesto	Yliriesto	___	___
      2 Víctor	Víctor	___	___
      2 Vulle	Vulle	___	___
      2 Viveca	Viveca	___	___
      2 Ville-Riiko	Ville-Riiko	___	___
      2 Villat	Villat	___	___
      2 Veahkki	Veahkki	___	___
      2 Vargas	Vargas	___	___
      2 Uhkevulážij	Uhkevulážij	___	___
      2 UNESCO	UNESCO	___	___
      2 Táál	Táál	___	___
      2 Tuáivumield	Tuáivumield	___	___
      2 Tiäddut	Tiäddut	___	___
      2 Teemu	Teemu	___	___
      2 Taina	Taina	___	___
      2 Tah	Tah	___	___
      2 Sämiparlamenttârij	Sämiparlamenttârij	___	___
      2 Sämi	Sämi	___	___
      2 Sára	Sára	___	___
      2 Stálu	Stálu	___	___
      2 Stipendih	Stipendih	___	___
      2 Statement	Statement	___	___
      2 Sosiaaldemokraatlâš	Sosiaaldemokraatlâš	___	___
      2 Sopmuš	Sopmuš	___	___
      2 Sonkkila	Sonkkila	___	___
      2 Soljust	Soljust	___	___
      2 Slap	Slap	___	___
      2 Siida	Siida	___	___
      2 Senaatti-kiddoduvâi	Senaatti-kiddoduvâi	___	___
      2 Seenaat-kidânjâsâi	Seenaat-kidânjâsâi	___	___
      2 Sasi	Sasi	___	___
      2 SaKaste-proojekt	SaKaste-proojekt	___	___
      2 SIERÂTIILÁÁMIST	SIERÂTIILÁÁMIST	___	___
      2 SAJOS	SAJOS	___	___
      2 SAIJOOS	SAIJOOS	___	___
      2 Rundgren	Rundgren	___	___
      2 Riinamari	Riinamari	___	___
      2 Riikka	Riikka	___	___
      2 Rights	Rights	___	___
      2 Pyylampi	Pyylampi	___	___
      2 Projekt	Projekt	___	___
      2 Piäcám	Piäcám	___	___
      2 Piret	Piret	___	___
      2 Paneelist	Paneelist	___	___
      2 Ovtâstumstaatah	Ovtâstumstaatah	___	___
      2 Ovtta	Ovtta	___	___
      2 Out	Out	___	___
      2 One	One	___	___
      2 Olmoošvuoigâdvuođâváldálâš	Olmoošvuoigâdvuođâváldálâš	___	___
      2 Olmoošvuoigâdvuođâváldálii	Olmoošvuoigâdvuođâváldálii	___	___
      2 Olmoošvuogâdvuođâpoolitlâš	Olmoošvuogâdvuođâpoolitlâš	___	___
      2 Ofelaš-materiaalijd	Ofelaš-materiaalijd	___	___
      2 Of	Of	___	___
      2 Näkkäläläjärvi-Länsman	Näkkäläläjärvi-Länsman	___	___
      2 Nuori	Nuori	___	___
      2 Nubbân	Nubbân	___	___
      2 Njeellim	Njeellim	___	___
      2 Nivavaara	Nivavaara	___	___
      2 Nilut	Nilut	___	___
      2 Napapiiri	Napapiiri	___	___
      2 Mánu	Mánu	___	___
      2 Máccihaldâttâs	Máccihaldâttâs	___	___
      2 Miessin	Miessin	___	___
      2 Meritiätuláin	Meritiätuláin	___	___
      2 Maikkula	Maikkula	___	___
      2 Ljetoff	Ljetoff	___	___
      2 Linjiimeh	Linjiimeh	___	___
      2 Lehtolantie	Lehtolantie	___	___
      2 KåŠllmuõrâž	KåŠllmuõrâž	___	___
      2 Kulttuuri	Kulttuuri	___	___
      2 Koulun	Koulun	___	___
      2 Koolgâp	Koolgâp	___	___
      2 Konfereensân	Konfereensân	___	___
      2 Koneen	Koneen	___	___
      2 Kok	Kok	___	___
      2 Koijâdâllâmluámáttuvvah	Koijâdâllâmluámáttuvvah	___	___
      2 Keski-Suomen	Keski-Suomen	___	___
      2 Keraamisij	Keraamisij	___	___
      2 Kalttopää	Kalttopää	___	___
      2 KOLLEKIELÂ	KOLLEKIELÂ	___	___
      2 KASTE	KASTE	___	___
      2 Juhán-Tuommá	Juhán-Tuommá	___	___
      2 Juhan-Tuomma	Juhan-Tuomma	___	___
      2 Jotonpieijum	Jotonpieijum	___	___
      2 JURGÂLEIJEE	JURGÂLEIJEE	___	___
      2 Ivaloiset	Ivaloiset	___	___
      2 Itäpuolen	Itäpuolen	___	___
      2 Irausquín	Irausquín	___	___
      2 Interreg-ruttâdlâš	Interreg-ruttâdlâš	___	___
      2 Interneetist	Interneetist	___	___
      2 Ijattes	Ijattes	___	___
      2 Ijahis	Ijahis	___	___
      2 Huolâttâssiisâmoonnâm	Huolâttâssiisâmoonnâm	___	___
      2 Hilbes	Hilbes	___	___
      2 Haukiputaa	Haukiputaa	___	___
      2 Hannes	Hannes	___	___
      2 Giron	Giron	___	___
      2 Gelencér	Gelencér	___	___
      2 Finnimnáál	Finnimnáál	___	___
      2 Festivaalâ	Festivaalâ	___	___
      2 Eellimvuáimálij	Eellimvuáimálij	___	___
      2 EU-Komissio	EU-Komissio	___	___
      2 Dániel	Dániel	___	___
      2 DVD.	DVD.	___	___
      2 D-Corp	D-Corp	___	___
      2 City-Sámit	City-Sámit	___	___
      2 Bánna	Bánna	___	___
      2 Buoidda	Buoidda	___	___
      2 Bräysy	Bräysy	___	___
      2 Bohccostallit	Bohccostallit	___	___
      2 Blueray-čuojânâs	Blueray-čuojânâs	___	___
      2 Birit	Birit	___	___
      2 Betonirakenne	Betonirakenne	___	___
      2 Beaivváš	Beaivváš	___	___
      2 Auttaja-Aslak	Auttaja-Aslak	___	___
      2 Aulis	Aulis	___	___
      2 Arkeologih	Arkeologih	___	___
      2 Anne-Maret	Anne-Maret	___	___
      2 Andte	Andte	___	___
      2 Allianssi	Allianssi	___	___
      2 Alanko-Kahiluoto	Alanko-Kahiluoto	___	___
      2 AUDITORIO	AUDITORIO	___	___
      2 ANARÂŠKIELÂ	ANARÂŠKIELÂ	___	___
      2 AANAAR	AANAAR	___	___
      2 8.10.–	8.10.–	___	___
      2 -‐ravvui	-‐ravvui	___	___
      1 €/mp	€/mp	___	___
      1 šáddááš	šáddááš	___	___
      1 šlááijân	šlááijân	___	___
      1 šleđgapostâčujottâsân	šleđgapostâčujottâsân	___	___
      1 šlaantah	šlaantah	___	___
      1 škovlâahasáid	škovlâahasáid	___	___
      1 škovlim-já	škovlim-já	___	___
      1 škovliittâttâđ	škovliittâttâđ	___	___
      1 šieu	šieu	___	___
      1 šeštâšuveh	šeštâšuveh	___	___
      1 šaddâ	šaddâ	___	___
      1 šaddočuágáldâhânkilgool	šaddočuágáldâhânkilgool	___	___
      1 šaddeđ	šaddeđ	___	___
      1 šad-deh	šad-deh	___	___
      1 ŠÁppes	ŠÁppes	___	___
      1 Šsäämi	Šsäämi	___	___
      1 ŠsämicekkiŠ	ŠsämicekkiŠ	___	___
      1 ŠsuhháidŠ	ŠsuhháidŠ	___	___
      1 ŠpäikkikiellânŠ	ŠpäikkikiellânŠ	___	___
      1 ŠpresidenttânŠ	ŠpresidenttânŠ	___	___
      1 Škvolim-	Škvolim-	___	___
      1 Škovlimpoolitlâš	Škovlimpoolitlâš	___	___
      1 Škooultõs-	Škooultõs-	___	___
      1 Šieu	Šieu	___	___
      1 Šadoid	Šadoid	___	___
      1 ŠTuoddâristŠ	ŠTuoddâristŠ	___	___
      1 ŠILJOPIIRÂS	ŠILJOPIIRÂS	___	___
      1 ŠBeaivvi	ŠBeaivvi	___	___
      1 Š-bláddi	Š-bláddi	___	___
      1 ŋâlâš	ŋâlâš	___	___
      1 čäällitáiđuttemmin	čäällitáiđuttemmin	___	___
      1 čäällimtáiđuttemmin	čäällimtáiđuttemmin	___	___
      1 čäällimnáál	čäällimnáál	___	___
      1 čääliđ	čääliđ	___	___
      1 čállus	čállus	___	___
      1 čáitáčij	čáitáčij	___	___
      1 čáitálâmâs	čáitálâmâs	___	___
      1 čáitálmâsân	čáitálmâsân	___	___
      1 čáitálmâsviistán	čáitálmâsviistán	___	___
      1 čáitálmâssali	čáitálmâssali	___	___
      1 čáitálmâsah	čáitálmâsah	___	___
      1 čáitálmâs-	čáitálmâs-	___	___
      1 čácáduavah	čácáduavah	___	___
      1 čyeijih	čyeijih	___	___
      1 čuážžud	čuážžud	___	___
      1 čuávvumnáál	čuávvumnáál	___	___
      1 čuávuvâs	čuávuvâs	___	___
      1 čuávuviih	čuávuviih	___	___
      1 čuávduđ	čuávduđ	___	___
      1 čuávdimnáál	čuávdimnáál	___	___
      1 čuásáttâhjuávkku	čuásáttâhjuávkku	___	___
      1 čuásáttâhjuávhuin	čuásáttâhjuávhuin	___	___
      1 čuásáttâhjuávhu	čuásáttâhjuávhu	___	___
      1 čuásáttâhhân	čuásáttâhhân	___	___
      1 čuáskimâs	čuáskimâs	___	___
      1 čuákánpiejâmist	čuákánpiejâmist	___	___
      1 čuákánkočom	čuákánkočom	___	___
      1 čuákkimčuásáttâhhân	čuákkimčuásáttâhhân	___	___
      1 čuákkimviistáid	čuákkimviistáid	___	___
      1 čuákkimtekniikâst	čuákkimtekniikâst	___	___
      1 čuákkimist19.12.2011	čuákkimist19.12.2011	___	___
      1 čuákkimaula	čuákkimaula	___	___
      1 čuágálduvvâin	čuágálduvvâin	___	___
      1 čuággáneh	čuággáneh	___	___
      1 čurmâmlinjâšrääpi	čurmâmlinjâšrääpi	___	___
      1 čuovâtuáiján	čuovâtuáiján	___	___
      1 čuovâkuvviimijnis	čuovâkuvviimijnis	___	___
      1 čuovâkovečáitálmâs	čuovâkovečáitálmâs	___	___
      1 čuovâkovemosaiik	čuovâkovemosaiik	___	___
      1 čuovvâdin	čuovvâdin	___	___
      1 čuakankiasu	čuakankiasu	___	___
      1 čočhâmáánu	čočhâmáánu	___	___
      1 čoovcâ	čoovcâ	___	___
      1 čonâdâttâmvuođâst	čonâdâttâmvuođâst	___	___
      1 čonâdâttâmvuođâs	čonâdâttâmvuođâs	___	___
      1 čokkâmsajeh	čokkâmsajeh	___	___
      1 čokkánij	čokkánij	___	___
      1 čokkán	čokkán	___	___
      1 čokkámráidud	čokkámráidud	___	___
      1 čokijdeijee	čokijdeijee	___	___
      1 čohčâčokkiimân	čohčâčokkiimân	___	___
      1 čohčamáánu	čohčamáánu	___	___
      1 čiččâmnubâlov	čiččâmnubâlov	___	___
      1 čiävláht	čiävláht	___	___
      1 čiälkkámušâstis	čiälkkámušâstis	___	___
      1 čielgâsmiteh	čielgâsmiteh	___	___
      1 čielgasavt	čielgasavt	___	___
      1 časijd	časijd	___	___
      1 čanosjuávkku-	čanosjuávkku-	___	___
      1 čanosjuávhuid	čanosjuávhuid	___	___
      1 čalluustân	čalluustân	___	___
      1 čajáttellee	čajáttellee	___	___
      1 čaabâ-	čaabâ-	___	___
      1 Čáukkim	Čáukkim	___	___
      1 Čáitáltâs	Čáitáltâs	___	___
      1 Čuávuváš	Čuávuváš	___	___
      1 Čuásáttâhjuávkkun	Čuásáttâhjuávkkun	___	___
      1 Čuákkimistis	Čuákkimistis	___	___
      1 Čuomâ	Čuomâ	___	___
      1 Čevetjävrmaađij	Čevetjävrmaađij	___	___
      1 ČUÁKKIMIŠEDEIJEE	ČUÁKKIMIŠEDEIJEE	___	___
      1 åhpadusguovdásjist	åhpadusguovdásjist	___	___
      1 äššitobdeepatgojuávhu	äššitobdeepatgojuávhu	___	___
      1 äššitobdeemekânismân	äššitobdeemekânismân	___	___
      1 äššigâšâid	äššigâšâid	___	___
      1 äššigâšpargo-	äššigâšpargo-	___	___
      1 äššigâšpalvâlusâinis	äššigâšpalvâlusâinis	___	___
      1 äššigâšpalvâlusâi	äššigâšpalvâlusâi	___	___
      1 äššigâšjuávhoid	äššigâšjuávhoid	___	___
      1 äššifeiluid	äššifeiluid	___	___
      1 ääšiomâhái	ääšiomâhái	___	___
      1 ääšijn	ääšijn	___	___
      1 äämi	äämi	___	___
      1 äälgin	äälgin	___	___
      1 ävkkinkevttim	ävkkinkevttim	___	___
      1 ärbivuáviljn	ärbivuáviljn	___	___
      1 ämmilij	ämmilij	___	___
      1 älkebin	älkebin	___	___
      1 äigittemvuođâ	äigittemvuođâ	___	___
      1 äigikyevdilâžžân	äigikyevdilâžžân	___	___
      1 áštuuvuálásii	áštuuvuálásii	___	___
      1 ášij	ášij	___	___
      1 áš	áš	___	___
      1 áávusorroo	áávusorroo	___	___
      1 áárvustan-neem	áárvustan-neem	___	___
      1 áárvuld	áárvuld	___	___
      1 áánšust	áánšust	___	___
      1 áámmátááiđu	áámmátááiđu	___	___
      1 áámmátváljim	áámmátváljim	___	___
      1 árvuštâllâmnavcâlâs	árvuštâllâmnavcâlâs	___	___
      1 árvuštâlluvvojeh	árvuštâlluvvojeh	___	___
      1 árvuštellii	árvuštellii	___	___
      1 árvušteleh	árvušteleh	___	___
      1 árbivuáváliih	árbivuáváliih	___	___
      1 árbi	árbi	___	___
      1 ámáttâh	ámáttâh	___	___
      1 áinošlajâsii	áinošlajâsii	___	___
      1 áijubân	áijubân	___	___
      1 áhkubatŠ	áhkubatŠ	___	___
      1 Äivihjäävrist	Äivihjäävrist	___	___
      1 Äijjih-	Äijjih-	___	___
      1 Árvesjávri	Árvesjávri	___	___
      1 Árjjatluovvi	Árjjatluovvi	___	___
      1 Ánnamáret	Ánnamáret	___	___
      1 Ánnamaret	Ánnamaret	___	___
      1 Ándde	Ándde	___	___
      1 Ále	Ále	___	___
      1 Áilegas	Áilegas	___	___
      1 Àddja	Àddja	___	___
      1 ´normaal	´normaal	___	___
      1 ´lli	´lli	___	___
      1 ´al´	´al´	___	___
      1 ¬šemvirgádâhân	¬šemvirgádâhân	___	___
      1 ¬toorjâ	¬toorjâ	___	___
      1 ¬tiijkán	¬tiijkán	___	___
      1 ¬tem-	¬tem-	___	___
      1 ¬mah	¬mah	___	___
      1 ¬kuávdáš	¬kuávdáš	___	___
      1 ¬jâvuáhádâhân	¬jâvuáhádâhân	___	___
      1 ¬hámásâšvuotân	¬hámásâšvuotân	___	___
      1 ¬háduv	¬háduv	___	___
      1 ¬goost	¬goost	___	___
      1 ¬ciälkkámuš	¬ciälkkámuš	___	___
      1 ¨–Pággu	¨–Pággu	___	___
      1 ¨–	¨–	___	___
      1 ¨čáálus	¨čáálus	___	___
      1 ¨vuođâi	¨vuođâi	___	___
      1 ¨vuođâ	¨vuođâ	___	___
      1 ¨tiijkán	¨tiijkán	___	___
      1 ¨sâš-koddeest	¨sâš-koddeest	___	___
      1 ¨pio-Laiti	¨pio-Laiti	___	___
      1 ¨pargoin	¨pargoin	___	___
      1 ¨ovtâstume	¨ovtâstume	___	___
      1 ¨mittemškovliittâs	¨mittemškovliittâs	___	___
      1 ¨luokka	¨luokka	___	___
      1 ¨juávhust	¨juávhust	___	___
      1 ¨jeempalvâlusâi	¨jeempalvâlusâi	___	___
      1 ¨hámásâšvuotân	¨hámásâšvuotân	___	___
      1 ¨gâdvuođâlii	¨gâdvuođâlii	___	___
      1 zoomaastâllâm	zoomaastâllâm	___	___
      1 vääivid	vääivid	___	___
      1 västitiđ	västitiđ	___	___
      1 västidâsah	västidâsah	___	___
      1 västidiččij	västidiččij	___	___
      1 värissavâjođetteijee	värissavâjođetteijee	___	___
      1 värisaavâjođeteijee	värisaavâjođeteijee	___	___
      1 välkikodálii	välkikodálii	___	___
      1 väldivirdásmittum	väldivirdásmittum	___	___
      1 väldipoolitlijd	väldipoolitlijd	___	___
      1 väldikudijrääjih	väldikudijrääjih	___	___
      1 väldikudijraajij	väldikudijraajij	___	___
      1 vááimuspargon	vááimuspargon	___	___
      1 vááimusjuávkun	vááimusjuávkun	___	___
      1 vááimusjuávhu	vááimusjuávhu	___	___
      1 vástásâš	vástásâš	___	___
      1 vástádâsâtis	vástádâsâtis	___	___
      1 vástuppeeiviv	vástuppeeiviv	___	___
      1 várriim	várriim	___	___
      1 váldututor	váldututor	___	___
      1 váldulâš	váldulâš	___	___
      1 váldulávdástellee	váldulávdástellee	___	___
      1 válduláiguláš	válduláiguláš	___	___
      1 válduluákan	válduluákan	___	___
      1 válduaamnâs-	válduaamnâs-	___	___
      1 váldu-uulmeh	váldu-uulmeh	___	___
      1 váldu-urkkodeijen	váldu-urkkodeijen	___	___
      1 váigâdup	váigâdup	___	___
      1 vádásmittám	vádásmittám	___	___
      1 váduhub	váduhub	___	___
      1 vyerkkih	vyerkkih	___	___
      1 vyehhin	vyehhin	___	___
      1 vuäŠpstemaaunâskoontâr	vuäŠpstemaaunâskoontâr	___	___
      1 vuâvâmkišto	vuâvâmkišto	___	___
      1 vuáđustasâi	vuáđustasâi	___	___
      1 vuáđusijdisguin	vuáđusijdisguin	___	___
      1 vuáđumateraaleh	vuáđumateraaleh	___	___
      1 vuáđudmist	vuáđudmist	___	___
      1 vuávámnáál	vuávámnáál	___	___
      1 vuávámn	vuávámn	___	___
      1 vuásáš	vuásáš	___	___
      1 vuástálistâm	vuástálistâm	___	___
      1 vuástavaaldij	vuástavaaldij	___	___
      1 vuássááh	vuássááh	___	___
      1 vuássáá	vuássáá	___	___
      1 vuássáin	vuássáin	___	___
      1 vuássáid	vuássáid	___	___
      1 vuárusavâstâllâmân	vuárusavâstâllâmân	___	___
      1 vuárdámušâi	vuárdámušâi	___	___
      1 vuárdámušah	vuárdámušah	___	___
      1 vuáldutoimân	vuáldutoimân	___	___
      1 vuáimánšoddâmân	vuáimánšoddâmân	___	___
      1 vuáimánšoddâm	vuáimánšoddâm	___	___
      1 vuáimánjoođeetmist	vuáimánjoođeetmist	___	___
      1 vuáhđulahâváljukoodán	vuáhđulahâváljukoodán	___	___
      1 vuáháduvvâin	vuáháduvvâin	___	___
      1 vuáháduvvâid	vuáháduvvâid	___	___
      1 vuoššâmuu	vuoššâmuu	___	___
      1 vuoččin	vuoččin	___	___
      1 vuov-vijn	vuov-vijn	___	___
      1 vuotânväldihánnáá	vuotânväldihánnáá	___	___
      1 vuosâluokkalalij	vuosâluokkalalij	___	___
      1 vuosâjasâš	vuosâjasâš	___	___
      1 vuossâmu	vuossâmu	___	___
      1 vuolgâsoo-jijn	vuolgâsoo-jijn	___	___
      1 vuoiŋâstemtilen	vuoiŋâstemtilen	___	___
      1 vuoiŋâstempuddâtilen	vuoiŋâstempuddâtilen	___	___
      1 vuoimmehuvvat	vuoimmehuvvat	___	___
      1 vuoigâtvuođah	vuoigâtvuođah	___	___
      1 vuoigâd	vuoigâd	___	___
      1 vuoidâdvuođah	vuoidâdvuođah	___	___
      1 vuobdui	vuobdui	___	___
      1 vuađuškoovla	vuađuškoovla	___	___
      1 vuavalašvuođa	vuavalašvuođa	___	___
      1 vorâsnálásâš	vorâsnálásâš	___	___
      1 vookaalmusikšlaajâi	vookaalmusikšlaajâi	___	___
      1 von	von	___	___
      1 viärmáin	viärmáin	___	___
      1 viärmádâhviestâdmistis	viärmádâhviestâdmistis	___	___
      1 visásmitteđ	visásmitteđ	___	___
      1 vistádâhân	vistádâhân	___	___
      1 vissâsávt	vissâsávt	___	___
      1 virheomâhááh	virheomâhááh	___	___
      1 virgeomâhâid	virgeomâhâid	___	___
      1 virgeomâhij	virgeomâhij	___	___
      1 virgeomáháid	virgeomáháid	___	___
      1 vijđásumos	vijđásumos	___	___
      1 vijđásuboh	vijđásuboh	___	___
      1 vijđásubbon	vijđásubbon	___	___
      1 vijđásubboid	vijđásubboid	___	___
      1 vijđásubboht-uv	vijđásubboht-uv	___	___
      1 vijđáhit	vijđáhit	___	___
      1 vijđht	vijđht	___	___
      1 viijđeeht	viijđeeht	___	___
      1 viijdáht	viijdáht	___	___
      1 vihkopargopitah	vihkopargopitah	___	___
      1 viggâmušáid	viggâmušáid	___	___
      1 viestâruásijn	viestâruásijn	___	___
      1 viestâdemniävvuid	viestâdemniävvuid	___	___
      1 viermikoijâdâllâmân	viermikoijâdâllâmân	___	___
      1 videopyevtittembeln	videopyevtittembeln	___	___
      1 videolágán	videolágán	___	___
      1 verdittijn	verdittijn	___	___
      1 venezuelalijd	venezuelalijd	___	___
      1 venezuelalii	venezuelalii	___	___
      1 veikkâpâ	veikkâpâ	___	___
      1 veddityeji	veddityeji	___	___
      1 vdâveedâ	vdâveedâ	___	___
      1 varijkevttim	varijkevttim	___	___
      1 valmâštuvvii	valmâštuvvii	___	___
      1 valmâštemnáál	valmâštemnáál	___	___
      1 valmâšteleh	valmâšteleh	___	___
      1 valmâstâllii	valmâstâllii	___	___
      1 valjimnáál	valjimnáál	___	___
      1 valjiimis	valjiimis	___	___
      1 vaikuttettee	vaikuttettee	___	___
      1 vai-kuttâs	vai-kuttâs	___	___
      1 vai	vai	___	___
      1 vaattâmvuođâtääsi	vaattâmvuođâtääsi	___	___
      1 vaaljâpojijmield	vaaljâpojijmield	___	___
      1 va-lastâllâmminister	va-lastâllâmminister	___	___
      1 uŋgárlii	uŋgárlii	___	___
      1 uđđâvuođpeeiviááptu	uđđâvuođpeeiviááptu	___	___
      1 uđđâsistteddilâs	uđđâsistteddilâs	___	___
      1 uđđâsisteddilâsah	uđđâsisteddilâsah	___	___
      1 uđâsmitteđ	uđâsmitteđ	___	___
      1 uážžoi	uážžoi	___	___
      1 uáši	uáši	___	___
      1 uáđđih	uáđđih	___	___
      1 uávilin	uávilin	___	___
      1 uásálâsvuođâ	uásálâsvuođâ	___	___
      1 uásálistâm	uásálistâm	___	___
      1 uásálistáin	uásálistáin	___	___
      1 uásálisteđ	uásálisteđ	___	___
      1 uásális	uásális	___	___
      1 uásláistám	uásláistám	___	___
      1 uáslist	uáslist	___	___
      1 uásitoimâdiskuin	uásitoimâdiskuin	___	___
      1 uásin	uásin	___	___
      1 uárnim	uárnim	___	___
      1 uápástem	uápástem	___	___
      1 uápásmin	uápásmin	___	___
      1 uáppâm	uáppâm	___	___
      1 uáppáh	uáppáh	___	___
      1 uápistemeh	uápistemeh	___	___
      1 uánisân	uánisân	___	___
      1 uálmui	uálmui	___	___
      1 uálgitoimâpääihih	uálgitoimâpääihih	___	___
      1 uálgisbeln	uálgisbeln	___	___
      1 uálgiaamnâsuáppeid	uálgiaamnâsuáppeid	___	___
      1 uáiváát-tân	uáiváát-tân	___	___
      1 uáivlduvvojeh	uáivlduvvojeh	___	___
      1 uáivilávtástellee	uáivilávtástellee	___	___
      1 uáinusânpieijâm	uáinusânpieijâm	___	___
      1 uuniik	uuniik	___	___
      1 uu	uu	___	___
      1 ut	ut	___	___
      1 usálisteh	usálisteh	___	___
      1 uskoldâhlâš	uskoldâhlâš	___	___
      1 uralilâš	uralilâš	___	___
      1 uppeekode	uppeekode	___	___
      1 unjin	unjin	___	___
      1 umesämmilâš	umesämmilâš	___	___
      1 ume-	ume-	___	___
      1 ulmud	ulmud	___	___
      1 ulla	ulla	___	___
      1 ulguupiälááš	ulguupiälááš	___	___
      1 ulguupiäláá	ulguupiäláá	___	___
      1 ulguupiäláid	ulguupiäláid	___	___
      1 ulbuubeln-uv	ulbuubeln-uv	___	___
      1 ucâmuuttáá	ucâmuuttáá	___	___
      1 ucâlumân	ucâlumân	___	___
      1 ucáluveh	ucáluveh	___	___
      1 ucáluumeest	ucáluumeest	___	___
      1 uccâmalliižih	uccâmalliižih	___	___
      1 uccâkaandâžin	uccâkaandâžin	___	___
      1 ucceeblohokielâh	ucceeblohokielâh	___	___
      1 ubâlâsvuottân	ubâlâsvuottân	___	___
      1 tävjibeht	tävjibeht	___	___
      1 täviv	täviv	___	___
      1 täsiárvuváldálâš	täsiárvuváldálâš	___	___
      1 täsivávt	täsivávt	___	___
      1 täsiviärdásiih	täsiviärdásiih	___	___
      1 tärhipeh	tärhipeh	___	___
      1 täpitormelávt	täpitormelávt	___	___
      1 táásá	táásá	___	___
      1 táárbumiled	táárbumiled	___	___
      1 táálášoht	táálášoht	___	___
      1 táálváá	táálváá	___	___
      1 tááidâtábáhtusâst	tááidâtábáhtusâst	___	___
      1 tááiduh	tááiduh	___	___
      1 táiđusâžžân	táiđusâžžân	___	___
      1 táiđusijn	táiđusijn	___	___
      1 táin	táin	___	___
      1 táibám	táibám	___	___
      1 táháhtus	táháhtus	___	___
      1 tábáhtusčuásáttâhhân	tábáhtusčuásáttâhhân	___	___
      1 tábáhtumest	tábáhtumest	___	___
      1 tyejees	tyejees	___	___
      1 tyeijiäärbi	tyeijiäärbi	___	___
      1 tyehijuurdân	tyehijuurdân	___	___
      1 tuđhâmettumeh	tuđhâmettumeh	___	___
      1 tuávvášmuštottemčalluid	tuávvášmuštottemčalluid	___	___
      1 tuávváškäägis	tuávváškäägis	___	___
      1 tuávváást	tuávváást	___	___
      1 tuámuštoovlist	tuámuštoovlist	___	___
      1 tuámmárin	tuámmárin	___	___
      1 tuáimâ	tuáimâ	___	___
      1 tuáimám	tuáimám	___	___
      1 tutortoimâ	tutortoimâ	___	___
      1 tutkâmusâi	tutkâmusâi	___	___
      1 tutkâmkuávdáiš	tutkâmkuávdáiš	___	___
      1 tur-viimist	tur-viimist	___	___
      1 tuorjuu	tuorjuu	___	___
      1 tuojijdâs	tuojijdâs	___	___
      1 tulâstâllâđ	tulâstâllâđ	___	___
      1 tulkkojuvvoo	tulkkojuvvoo	___	___
      1 tuhledemnáál	tuhledemnáál	___	___
      1 tuhhittettee	tuhhittettee	___	___
      1 tuhhiittiččij	tuhhiittiččij	___	___
      1 tuhhiittemnáál	tuhhiittemnáál	___	___
      1 tuble-CD	tuble-CD	___	___
      1 tubdâttetteevuođâ	tubdâttetteevuođâ	___	___
      1 trad	trad	___	___
      1 torve-jum	torve-jum	___	___
      1 topeliaansâš	topeliaansâš	___	___
      1 tooŋâsšadolâsvuođâ	tooŋâsšadolâsvuođâ	___	___
      1 toorjâtárbuin	toorjâtárbuin	___	___
      1 tooimânpieijâđ	tooimânpieijâđ	___	___
      1 tooimânpieijum	tooimânpieijum	___	___
      1 tooimâidis	tooimâidis	___	___
      1 tolebáást	tolebáást	___	___
      1 toimâohjelmâst	toimâohjelmâst	___	___
      1 toimâoh-‐	toimâoh-‐	___	___
      1 toimâlâs	toimâlâs	___	___
      1 toimmii	toimmii	___	___
      1 tobdosumosáid	tobdosumosáid	___	___
      1 tiäđujyehimân	tiäđujyehimân	___	___
      1 tiäđuhalulijd	tiäđuhalulijd	___	___
      1 tiätuvuotân	tiätuvuotân	___	___
      1 tiätunadelemistis	tiätunadelemistis	___	___
      1 tiäddutmáin	tiäddutmáin	___	___
      1 tiäddudmân	tiäddudmân	___	___
      1 tipšomnáál	tipšomnáál	___	___
      1 tinvuávám	tinvuávám	___	___
      1 tilálâšvuotân´	tilálâšvuotân´	___	___
      1 tilálâšvuo	tilálâšvuo	___	___
      1 tilálášvuotân	tilálášvuotân	___	___
      1 tilitärhistemmuštâluš	tilitärhistemmuštâluš	___	___
      1 tiilámnáál	tiilámnáál	___	___
      1 tihtâkirjestân	tihtâkirjestân	___	___
      1 tieđettemčáluseh	tieđettemčáluseh	___	___
      1 tievâsmiteh	tievâsmiteh	___	___
      1 tietumaašin	tietumaašin	___	___
      1 tiervâsvuođâpoolitlâš	tiervâsvuođâpoolitlâš	___	___
      1 tienievt	tienievt	___	___
      1 tiedâttâs	tiedâttâs	___	___
      1 tiatukaldei	tiatukaldei	___	___
      1 teve-eennâlmlii	teve-eennâlmlii	___	___
      1 terminologiaportaal	terminologiaportaal	___	___
      1 tematlâš	tematlâš	___	___
      1 televisost	televisost	___	___
      1 tekniikâst	tekniikâst	___	___
      1 tekniikaid	tekniikaid	___	___
      1 tehálâs	tehálâs	___	___
      1 teevstân	teevstân	___	___
      1 teesi	teesi	___	___
      1 teemâst	teemâst	___	___
      1 teatterčájáttâsáid	teatterčájáttâsáid	___	___
      1 teatterčájáttusâin	teatterčájáttusâin	___	___
      1 teatterčáitáldâsah	teatterčáitáldâsah	___	___
      1 teatterparjopääjih	teatterparjopääjih	___	___
      1 teatteripargo	teatteripargo	___	___
      1 tađemield	tađemield	___	___
      1 tavlust	tavlust	___	___
      1 tavesämikielâtáiđusâš	tavesämikielâtáiđusâš	___	___
      1 tavesämikeilân	tavesämikeilân	___	___
      1 tavesâämikielâlii	tavesâämikielâlii	___	___
      1 tave-eennâmláš	tave-eennâmláš	___	___
      1 tave-eennâmli	tave-eennâmli	___	___
      1 tatavesämikielâ	tatavesämikielâ	___	___
      1 tarvâniđ	tarvâniđ	___	___
      1 tarbu	tarbu	___	___
      1 tapiola-lansman	tapiola-lansman	___	___
      1 tapiola	tapiola	___	___
      1 tanssâst	tanssâst	___	___
      1 takkuustellii	takkuustellii	___	___
      1 taiđârij	taiđârij	___	___
      1 taikalamppu	taikalamppu	___	___
      1 taazâlâš	taazâlâš	___	___
      1 taarbâđ	taarbâđ	___	___
      1 taanivvááš	taanivvááš	___	___
      1 taaiđâčáitálmâssáid	taaiđâčáitálmâssáid	___	___
      1 taaiđui	taaiđui	___	___
      1 sääŠmkiõll	sääŠmkiõll	___	___
      1 säärnidmist	säärnidmist	___	___
      1 säämas	säämas	___	___
      1 säällimkoddeest	säällimkoddeest	___	___
      1 sätináálá	sätináálá	___	___
      1 sänituálvoojin	sänituálvoojin	___	___
      1 sämmilâšvuástásiih	sämmilâšvuástásiih	___	___
      1 sämmilâšpuárásij	sämmilâšpuárásij	___	___
      1 sämmilâšmätteid	sämmilâšmätteid	___	___
      1 sämmilâskirjimij	sämmilâskirjimij	___	___
      1 sämmi-lij	sämmi-lij	___	___
      1 sämičuásáttuvâi	sämičuásáttuvâi	___	___
      1 sämivuođâ	sämivuođâ	___	___
      1 sämitáiđusij	sämitáiđusij	___	___
      1 sämityejitek-niikâid	sämityejitek-niikâid	___	___
      1 sämitiggelaahâpargojuávhu	sämitiggelaahâpargojuávhu	___	___
      1 sämisiärváduvvâin	sämisiärváduvvâin	___	___
      1 sämipoolitlâš	sämipoolitlâš	___	___
      1 sämipoolitlii	sämipoolitlii	___	___
      1 sämipirrâsân.“Maid	sämipirrâsân.“Maid	___	___
      1 sämipedagogiikâst	sämipedagogiikâst	___	___
      1 sämiparlamenttârijn	sämiparlamenttârijn	___	___
      1 sämiparlamenttârij	sämiparlamenttârij	___	___
      1 sämiparlameentah	sämiparlameentah	___	___
      1 sämimáccuhân	sämimáccuhân	___	___
      1 sämimáccuháid	sämimáccuháid	___	___
      1 sämimusikkist	sämimusikkist	___	___
      1 sämimosaiikist	sämimosaiikist	___	___
      1 sämimaccuhân	sämimaccuhân	___	___
      1 sämiluvâttâvâst	sämiluvâttâvâst	___	___
      1 sämikuáv-lu	sämikuáv-lu	___	___
      1 sämikuálvu	sämikuálvu	___	___
      1 sämikilâliih	sämikilâliih	___	___
      1 sämikielâtáiđusijd	sämikielâtáiđusijd	___	___
      1 sämikielâtáiđusiih	sämikielâtáiđusiih	___	___
      1 sämikielâlâlâš	sämikielâlâlâš	___	___
      1 sämikieltáiđusijd	sämikieltáiđusijd	___	___
      1 sämijuoigei	sämijuoigei	___	___
      1 sämiilâš	sämiilâš	___	___
      1 sämiarttâsâš	sämiarttâsâš	___	___
      1 sämi-iäláttásâid	sämi-iäláttásâid	___	___
      1 sämi	sämi	___	___
      1 sä-misopâmuš	sä-misopâmuš	___	___
      1 sä-mikielâlâš	sä-mikielâlâš	___	___
      1 sámiid	sámiid	___	___
      1 sámi	sámi	___	___
      1 sámegiella	sámegiella	___	___
      1 sámegiela	sámegiela	___	___
      1 sámediggi	sámediggi	___	___
      1 sáimám	sáimám	___	___
      1 symbolisist	symbolisist	___	___
      1 syemmilâš-ugrilâš	syemmilâš-ugrilâš	___	___
      1 syemmilâš-senegalâš	syemmilâš-senegalâš	___	___
      1 suáđijd	suáđijd	___	___
      1 suáđij	suáđij	___	___
      1 suájást	suájást	___	___
      1 suáijáás	suáijáás	___	___
      1 suáijááh	suáijááh	___	___
      1 suáijáá	suáijáá	___	___
      1 suunnâttâllâp	suunnâttâllâp	___	___
      1 suunnâttâllum	suunnâttâllum	___	___
      1 suunnâttâleh	suunnâttâleh	___	___
      1 suulágánáid	suulágánáid	___	___
      1 suuijâi	suuijâi	___	___
      1 suopânáin	suopânáin	___	___
      1 suomâráp	suomâráp	___	___
      1 suojelusâst	suojelusâst	___	___
      1 suogârdeleh	suogârdeleh	___	___
      1 sundášuvá	sundášuvá	___	___
      1 sundášume	sundášume	___	___
      1 suhâpuolvái	suhâpuolvái	___	___
      1 suddâlumviggâmušâin	suddâlumviggâmušâin	___	___
      1 subarktâlâš	subarktâlâš	___	___
      1 stälitaldrigijn	stälitaldrigijn	___	___
      1 styerebin	styerebin	___	___
      1 stuuime	stuuime	___	___
      1 streaming	streaming	___	___
      1 stream-vuolgâttâssáin	stream-vuolgâttâssáin	___	___
      1 stream-vuolgâttâs	stream-vuolgâttâs	___	___
      1 stream-vuolgâtteh	stream-vuolgâtteh	___	___
      1 stream-vuolgâtmist	stream-vuolgâtmist	___	___
      1 strategiâid	strategiâid	___	___
      1 stipendâ	stipendâ	___	___
      1 stipenda	stipenda	___	___
      1 statistiikâid	statistiikâid	___	___
      1 staatâuásusvuá	staatâuásusvuá	___	___
      1 staatâtoor	staatâtoor	___	___
      1 staatârađđijn	staatârađđijn	___	___
      1 staatâkuáhtásâš	staatâkuáhtásâš	___	___
      1 staatâkuáhtásiih	staatâkuáhtásiih	___	___
      1 staatâiguin	staatâiguin	___	___
      1 st	st	___	___
      1 språk	språk	___	___
      1 spesiaalčáitálmâsân	spesiaalčáitálmâsân	___	___
      1 spesiaaläššitobdee	spesiaaläššitobdee	___	___
      1 spesiaalâšum	spesiaalâšum	___	___
      1 spesiaalvuávájeijee	spesiaalvuávájeijee	___	___
      1 spesiaalsteppâl	spesiaalsteppâl	___	___
      1 spesiaalpyecceetipšo-	spesiaalpyecceetipšo-	___	___
      1 spesiaalpyecceetipšo	spesiaalpyecceetipšo	___	___
      1 spesiaalkyessin	spesiaalkyessin	___	___
      1 sosiaalâš	sosiaalâš	___	___
      1 sosiaalneuvos	sosiaalneuvos	___	___
      1 sosiaal-já	sosiaal-já	___	___
      1 sopâmušvuáđusâš	sopâmušvuáđusâš	___	___
      1 soi-jimpäikkikoddeest	soi-jimpäikkikoddeest	___	___
      1 sogku	sogku	___	___
      1 soagŋomátki	soagŋomátki	___	___
      1 smaavâtuojij	smaavâtuojij	___	___
      1 smaavâmeccivalje	smaavâmeccivalje	___	___
      1 sleđgâpostáin	sleđgâpostáin	___	___
      1 skáppojuvvojeh	skáppojuvvojeh	___	___
      1 skipárijdânguin	skipárijdânguin	___	___
      1 siärvásteleh	siärvásteleh	___	___
      1 siärvušân	siärvušân	___	___
      1 siärvušáid	siärvušáid	___	___
      1 siärvuslâsvuođâlâš	siärvuslâsvuođâlâš	___	___
      1 siäm	siäm	___	___
      1 sisčaasij	sisčaasij	___	___
      1 sistetoollâm	sistetoollâm	___	___
      1 sispolitiikâst	sispolitiikâst	___	___
      1 sirdášuvá	sirdášuvá	___	___
      1 sirdumääigih	sirdumääigih	___	___
      1 sirdumnjuolgâdusâid	sirdumnjuolgâdusâid	___	___
      1 sirdumnjuolgâdusâi	sirdumnjuolgâdusâi	___	___
      1 sirdojuvvii	sirdojuvvii	___	___
      1 sillanpaa	sillanpaa	___	___
      1 sijđoh:158	sijđoh:158	___	___
      1 sijđoh:111	sijđoh:111	___	___
      1 sijdâvuáháduumeest	sijdâvuáháduumeest	___	___
      1 sijdiist	sijdiist	___	___
      1 siirdâseinijn	siirdâseinijn	___	___
      1 sierânâssajâttuv	sierânâssajâttuv	___	___
      1 sierânâsruttâdâssáin	sierânâsruttâdâssáin	___	___
      1 sieralagan	sieralagan	___	___
      1 sieidáid	sieidáid	___	___
      1 show-čájáttâssáid	show-čájáttâssáid	___	___
      1 shaamaanrumbuinis	shaamaanrumbuinis	___	___
      1 seurujarvi-kari	seurujarvi-kari	___	___
      1 sesânin	sesânin	___	___
      1 sessiisteleh	sessiisteleh	___	___
      1 seminarâst	seminarâst	___	___
      1 selvâttâsâi	selvâttâsâi	___	___
      1 selvâttâs	selvâttâs	___	___
      1 seinireliefi	seinireliefi	___	___
      1 searvi	searvi	___	___
      1 savâstâldijn	savâstâldijn	___	___
      1 savâstis	savâstis	___	___
      1 savastâl	savastâl	___	___
      1 sattummield	sattummield	___	___
      1 sanijguim	sanijguim	___	___
      1 sanij-guin	sanij-guin	___	___
      1 samisk	samisk	___	___
      1 sametinget	sametinget	___	___
      1 salibandy	salibandy	___	___
      1 sajâttâhân	sajâttâhân	___	___
      1 sajoidittoo	sajoidittoo	___	___
      1 sajatuv	sajatuv	___	___
      1 sajattuvâs	sajattuvâs	___	___
      1 sajasâšvuođá	sajasâšvuođá	___	___
      1 sajanmávsoin	sajanmávsoin	___	___
      1 saijaavuotâ	saijaavuotâ	___	___
      1 sahavuáru	sahavuáru	___	___
      1 saavât	saavât	___	___
      1 saavâjođettemvuotâvuárust	saavâjođettemvuotâvuárust	___	___
      1 rääpin	rääpin	___	___
      1 rääpi	rääpi	___	___
      1 rääjjin	rääjjin	___	___
      1 rävisolmoošškovlittâs	rävisolmoošškovlittâs	___	___
      1 rätt	rätt	___	___
      1 räppin	räppin	___	___
      1 räpp	räpp	___	___
      1 räpmuusik	räpmuusik	___	___
      1 räp-muusik	räp-muusik	___	___
      1 räp-artist	räp-artist	___	___
      1 räjiorniimijn	räjiorniimijn	___	___
      1 räiđu	räiđu	___	___
      1 rähtá	rähtá	___	___
      1 ráđádâllâmpuáttusân	ráđádâllâmpuáttusân	___	___
      1 ráđádeleh	ráđádeleh	___	___
      1 rááđhást	rááđhást	___	___
      1 rávdnji	rávdnji	___	___
      1 ráppáđ	ráppáđ	___	___
      1 rájálâšvuođâst	rájálâšvuođâst	___	___
      1 ráhtádâtâi	ráhtádâtâi	___	___
      1 ráhtimáid	ráhtimáid	___	___
      1 ráh-tusijd	ráh-tusijd	___	___
      1 ruukitooimâst	ruukitooimâst	___	___
      1 ruukilopeucâmuššáid	ruukilopeucâmuššáid	___	___
      1 ruukilahâaašij	ruukilahâaašij	___	___
      1 ruukihaavah	ruukihaavah	___	___
      1 roockist	roockist	___	___
      1 rockáá	rockáá	___	___
      1 rivdâđ	rivdâđ	___	___
      1 ritmâmuusik-	ritmâmuusik-	___	___
      1 riessâmeh	riessâmeh	___	___
      1 riehtâčäällimvyehi	riehtâčäällimvyehi	___	___
      1 revitalisistem	revitalisistem	___	___
      1 restonomân	restonomân	___	___
      1 related	related	___	___
      1 rehálâšvuotâ	rehálâšvuotâ	___	___
      1 refleksiivlijd	refleksiivlijd	___	___
      1 reesuurskuávdážžân	reesuurskuávdážžân	___	___
      1 ravvimnáál	ravvimnáál	___	___
      1 ravintola	ravintola	___	___
      1 ratifisistemprooseess	ratifisistemprooseess	___	___
      1 rastaldit	rastaldit	___	___
      1 rapp	rapp	___	___
      1 raje	raje	___	___
      1 rahtteteh	rahtteteh	___	___
      1 raađhâš	raađhâš	___	___
      1 päsiškuođij	päsiškuođij	___	___
      1 pärnikuáhtásâš	pärnikuáhtásâš	___	___
      1 pälgájalgejeijee	pälgájalgejeijee	___	___
      1 päikkilágán	päikkilágán	___	___
      1 päikkienâmistis	päikkienâmistis	___	___
      1 párnáás	párnáás	___	___
      1 párnáikultuurkuávdáš	párnáikultuurkuávdáš	___	___
      1 párnáiguim	párnáiguim	___	___
      1 pálkkáttijn	pálkkáttijn	___	___
      1 pággusuddâludduu	pággusuddâludduu	___	___
      1 pygálusäigi	pygálusäigi	___	___
      1 pygálusâi	pygálusâi	___	___
      1 pygálusah	pygálusah	___	___
      1 pygálus	pygálus	___	___
      1 pyevtittâsoovdânpyehtimeh,*	pyevtittâsoovdânpyehtimeh,*	___	___
      1 pyeremussáid	pyeremussáid	___	___
      1 pyereestváijeemstaatâ	pyereestváijeemstaatâ	___	___
      1 pyereestvaijeemstrategilâš	pyereestvaijeemstrategilâš	___	___
      1 pyereestvai	pyereestvai	___	___
      1 pyereestpuáttám	pyereestpuáttám	___	___
      1 puđâlsâssáidân	puđâlsâssáidân	___	___
      1 puđâlmijnân	puđâlmijnân	___	___
      1 puáđusáid	puáđusáid	___	___
      1 puáđusijn	puáđusijn	___	___
      1 puáđuseh	puáđuseh	___	___
      1 puátudijdiskuin	puátudijdiskuin	___	___
      1 puátteevuđâst	puátteevuđâst	___	___
      1 puásuituálukulttuus	puásuituálukulttuus	___	___
      1 puásuisalami	puásuisalami	___	___
      1 puásuisafarijd	puásuisafarijd	___	___
      1 puárásji-	puárásji-	___	___
      1 puáhâin	puáhâin	___	___
      1 puuđââld	puuđââld	___	___
      1 puuvkoš	puuvkoš	___	___
      1 pusuičokkiimijn	pusuičokkiimijn	___	___
      1 pustávijd	pustávijd	___	___
      1 purrâmâžžân	purrâmâžžân	___	___
      1 purrâmužžân	purrâmužžân	___	___
      1 puovtii	puovtii	___	___
      1 puohtuučij	puohtuučij	___	___
      1 puohtiijn	puohtiijn	___	___
      1 puohhâin	puohhâin	___	___
      1 puo	puo	___	___
      1 punjabi-	punjabi-	___	___
      1 puhe	puhe	___	___
      1 pudjetist	pudjetist	___	___
      1 provisions	provisions	___	___
      1 prosessáid	prosessáid	___	___
      1 proojeetvästideijen	proojeetvästideijen	___	___
      1 proojeektjovdâ	proojeektjovdâ	___	___
      1 priivaatvuoigâdvuođâlâš	priivaatvuoigâdvuođâlâš	___	___
      1 priivaatulmui	priivaatulmui	___	___
      1 prii-vaatčáitálmâsâid	prii-vaatčáitálmâsâid	___	___
      1 praktiiklávt	praktiiklávt	___	___
      1 povdám	povdám	___	___
      1 povdejum	povdejum	___	___
      1 potretist	potretist	___	___
      1 porgân	porgân	___	___
      1 poprock	poprock	___	___
      1 pop-rock-muusik	pop-rock-muusik	___	___
      1 pop-muusik	pop-muusik	___	___
      1 poolitlâš-jiešhaaldâšlâš	poolitlâš-jiešhaaldâšlâš	___	___
      1 pooliitlâš-haaldâtlâš	pooliitlâš-haaldâtlâš	___	___
      1 politiikan	politiikan	___	___
      1 politiijkân	politiijkân	___	___
      1 poliitlâš	poliitlâš	___	___
      1 poliitijkkáreh	poliitijkkáreh	___	___
      1 pištij	pištij	___	___
      1 piäránaddeelmettumvuođáin	piäránaddeelmettumvuođáin	___	___
      1 piäládâhpoolitliih	piäládâhpoolitliih	___	___
      1 piähtusijdiskuin	piähtusijdiskuin	___	___
      1 piäcámsiijdâliih	piäcámsiijdâliih	___	___
      1 pivnoshisvuođâ	pivnoshisvuođâ	___	___
      1 pivdokultturist	pivdokultturist	___	___
      1 pittáám-	pittáám-	___	___
      1 pistá	pistá	___	___
      1 pisoviih	pisoviih	___	___
      1 pisotteleh	pisotteleh	___	___
      1 pirâštiipšon	pirâštiipšon	___	___
      1 pirâsneuvos	pirâsneuvos	___	___
      1 pijsáá	pijsáá	___	___
      1 pihtâsin	pihtâsin	___	___
      1 pihtsijn	pihtsijn	___	___
      1 pihtsijd	pihtsijd	___	___
      1 piejâv	piejâv	___	___
      1 piejum	piejum	___	___
      1 pieivikiäččusaijeen	pieivikiäččusaijeen	___	___
      1 pieggâvyeimiuásikaava	pieggâvyeimiuásikaava	___	___
      1 pieggâvyeimialmoskaava	pieggâvyeimialmoskaava	___	___
      1 pieggâvuáimáttuvâi	pieggâvuáimáttuvâi	___	___
      1 piegguuttâttâđ	piegguuttâttâđ	___	___
      1 persovnkuáhtásâš	persovnkuáhtásâš	___	___
      1 persoon	persoon	___	___
      1 people	people	___	___
      1 pelnubihásii	pelnubihásii	___	___
      1 peljičuopâstuvâi	peljičuopâstuvâi	___	___
      1 peleväldimistis	peleväldimistis	___	___
      1 peivinaaveer	peivinaaveer	___	___
      1 peivikiäčust	peivikiäčust	___	___
      1 pehtiliteh	pehtiliteh	___	___
      1 peerustškuođij	peerustškuođij	___	___
      1 peerustškuottii	peerustškuottii	___	___
      1 pedâgooglijd	pedâgooglijd	___	___
      1 paččveiliih	paččveiliih	___	___
      1 parlâmentaarlâš	parlâmentaarlâš	___	___
      1 parlamiänttárid	parlamiänttárid	___	___
      1 parlamenttâtáálu	parlamenttâtáálu	___	___
      1 parlamenttâráid	parlamenttâráid	___	___
      1 parlamentaarlâs	parlamentaarlâs	___	___
      1 parlameentâst	parlameentâst	___	___
      1 pargoviehâpoolitliih	pargoviehâpoolitliih	___	___
      1 pargoviehâpoolitlii	pargoviehâpoolitlii	___	___
      1 pargoviehâpooliitlij	pargoviehâpooliitlij	___	___
      1 pargotuođâstâsijguin	pargotuođâstâsijguin	___	___
      1 pargopittákirjáážih	pargopittákirjáážih	___	___
      1 pargopitah	pargopitah	___	___
      1 para-	para-	___	___
      1 par	par	___	___
      1 palvâlušâiguin	palvâlušâiguin	___	___
      1 palvâlusânväldimvuáháduvâi	palvâlusânväldimvuáháduvâi	___	___
      1 palvâlusprosessijn	palvâlusprosessijn	___	___
      1 palhâšuvvii	palhâšuvvii	___	___
      1 palhâšumáin	palhâšumáin	___	___
      1 palhâšumeuážžon	palhâšumeuážžon	___	___
      1 palhešume	palhešume	___	___
      1 pajeuáppeečálusijn-uv	pajeuáppeečálusijn-uv	___	___
      1 pajeuáppeečálusijn	pajeuáppeečálusijn	___	___
      1 paijeentuállen	paijeentuállen	___	___
      1 paijeentuállein	paijeentuállein	___	___
      1 paijeen-toollâđ	paijeen-toollâđ	___	___
      1 paijeelpäccee	paijeelpäccee	___	___
      1 paijeelmiärásijd	paijeelmiärásijd	___	___
      1 pahlhášume	pahlhášume	___	___
      1 paalgâtääigi	paalgâtääigi	___	___
      1 paajaapiäláá	paajaapiäláá	___	___
      1 paabuid	paabuid	___	___
      1 ovtâstiteh	ovtâstiteh	___	___
      1 ovtâstemorgaaneh	ovtâstemorgaaneh	___	___
      1 ovtâskâš	ovtâskâš	___	___
      1 ovtâskâsulmuit	ovtâskâsulmuit	___	___
      1 ovtáskim	ovtáskim	___	___
      1 ovdâmoodeernlâš	ovdâmoodeernlâš	___	___
      1 ovdâmerkkân:*	ovdâmerkkân:*	___	___
      1 ovdánemimáhđulâšvuođah	ovdánemimáhđulâšvuođah	___	___
      1 ovdánemes	ovdánemes	___	___
      1 ovdevem	ovdevem	___	___
      1 ovdeláámainâšum	ovdeláámainâšum	___	___
      1 ovdedmist	ovdedmist	___	___
      1 ovdedemčuásáttuvâi	ovdedemčuásáttuvâi	___	___
      1 ovdedemrááhtusproojeekt	ovdedemrááhtusproojeekt	___	___
      1 ovdedempolitiijkâst	ovdedempolitiijkâst	___	___
      1 ovdebái	ovdebái	___	___
      1 oula	oula	___	___
      1 otsâšpargo-orgaan	otsâšpargo-orgaan	___	___
      1 othsis	othsis	___	___
      1 ostoost	ostoost	___	___
      1 oskomield	oskomield	___	___
      1 ortodoksâlâš	ortodoksâlâš	___	___
      1 ortodoksâlijd	ortodoksâlijd	___	___
      1 orniimeh	orniimeh	___	___
      1 orkestermusikist	orkestermusikist	___	___
      1 orjâlâskielâ	orjâlâskielâ	___	___
      1 organi-saatioh	organi-saatioh	___	___
      1 orgaanâi	orgaanâi	___	___
      1 org-nettisiijđoi	org-nettisiijđoi	___	___
      1 oppâre-gisterváldusist	oppâre-gisterváldusist	___	___
      1 oppâmateriaalčáitálmâs	oppâmateriaalčáitálmâs	___	___
      1 oppâmateriaalâid	oppâmateriaalâid	___	___
      1 oppâmateriaalah	oppâmateriaalah	___	___
      1 oppâamnasij	oppâamnasij	___	___
      1 oppimateriaalvaarij	oppimateriaalvaarij	___	___
      1 oppimateriaalitoimisto	oppimateriaalitoimisto	___	___
      1 oppamateriaal	oppamateriaal	___	___
      1 opas	opas	___	___
      1 oovtâsttoimâmkenigâsvuotâ	oovtâsttoimâmkenigâsvuotâ	___	___
      1 oovtâstjotten	oovtâstjotten	___	___
      1 oovtâst-pargoost	oovtâst-pargoost	___	___
      1 oovtâspargo-	oovtâspargo-	___	___
      1 oovtâpiälásâžžân	oovtâpiälásâžžân	___	___
      1 oovtviärdásâšvuođâváldálâžân	oovtviärdásâšvuođâváldálâžân	___	___
      1 oovtviärdásij	oovtviärdásij	___	___
      1 oovtpiäiválâš	oovtpiäiválâš	___	___
      1 oovtnálásittum	oovtnálásittum	___	___
      1 oovtnálásittiđ	oovtnálásittiđ	___	___
      1 oovtmiäldásâš	oovtmiäldásâš	___	___
      1 oovtmielâlâš	oovtmielâlâš	___	___
      1 oovedmân	oovedmân	___	___
      1 oovdânpyehtimnáál	oovdânpyehtimnáál	___	___
      1 oovdânpuovttijn	oovdânpuovttijn	___	___
      1 oovdânpuovtii	oovdânpuovtii	___	___
      1 oovdânpuahtá	oovdânpuahtá	___	___
      1 oovdâ	oovdâ	___	___
      1 oovdeeld	oovdeeld	___	___
      1 oovdedškyettiđ	oovdedškyettiđ	___	___
      1 oommâm	oommâm	___	___
      1 oohtânsuddâluveh	oohtânsuddâluveh	___	___
      1 oohtânrekinistum	oohtânrekinistum	___	___
      1 oohtânkuulluuvâšvuođâ	oohtânkuulluuvâšvuođâ	___	___
      1 oohtânkullojeijee	oohtânkullojeijee	___	___
      1 oohtânheiviittiđ	oohtânheiviittiđ	___	___
      1 omâsteijeevuođâ	omâsteijeevuođâ	___	___
      1 omâhái	omâhái	___	___
      1 olášuttá	olášuttá	___	___
      1 olášuttemn	olášuttemn	___	___
      1 olášut-mist	olášut-mist	___	___
      1 olášumist	olášumist	___	___
      1 olášumes	olášumes	___	___
      1 olášittiđ	olášittiđ	___	___
      1 oláttâsohjelm	oláttâsohjelm	___	___
      1 oláttâskyessin	oláttâskyessin	___	___
      1 oláttum	oláttum	___	___
      1 olásume	olásume	___	___
      1 olympialij	olympialij	___	___
      1 olmâlágán	olmâlágán	___	___
      1 olmoošvuoigâdvuođâváldálâžân	olmoošvuoigâdvuođâváldálâžân	___	___
      1 olmoošvuoigâdvuođâpojitiijkâst	olmoošvuoigâdvuođâpojitiijkâst	___	___
      1 olmoošvuoigâdvuotorgaanij	olmoošvuoigâdvuotorgaanij	___	___
      1 olmoošvuoigâdvuotkomitea	olmoošvuoigâdvuotkomitea	___	___
      1 olmoošvuoigâdvuot-lahâasâttem	olmoošvuoigâdvuot-lahâasâttem	___	___
      1 olmoošvuigâdvuođârääđi	olmoošvuigâdvuođârääđi	___	___
      1 olmoošresurssijd	olmoošresurssijd	___	___
      1 olmooš-vuoigâdvuotkomissaar	olmooš-vuoigâdvuotkomissaar	___	___
      1 ollâsávt	ollâsávt	___	___
      1 olleemvuotâ	olleemvuotâ	___	___
      1 olgoštemváldálâš	olgoštemváldálâš	___	___
      1 olgospyehtiđ	olgospyehtiđ	___	___
      1 olgospuovtij	olgospuovtij	___	___
      1 olgopiäláá	olgopiäláá	___	___
      1 olesmiärásâš	olesmiärásâš	___	___
      1 oleskukkosâš	oleskukkosâš	___	___
      1 oleskukkosii	oleskukkosii	___	___
      1 oinuumettumin	oinuumettumin	___	___
      1 oinumvuođâ	oinumvuođâ	___	___
      1 ohtâšpargon	ohtâšpargon	___	___
      1 ohtââ	ohtââ	___	___
      1 ohtâvuođâvälimijd	ohtâvuođâvälimijd	___	___
      1 ohtâvuođâtolâmân	ohtâvuođâtolâmân	___	___
      1 ohtsâšpargo-orgaanâst	ohtsâšpargo-orgaanâst	___	___
      1 ohtsâšpalaveráid	ohtsâšpalaveráid	___	___
      1 ohtsâspargon	ohtsâspargon	___	___
      1 ohtsâskodálijn	ohtsâskodálijn	___	___
      1 ohtsâsibárdâsist	ohtsâsibárdâsist	___	___
      1 ohsâšpargo	ohsâšpargo	___	___
      1 ohstis	ohstis	___	___
      1 ohjelmpalvelemirâttâs	ohjelmpalvelemirâttâs	___	___
      1 ofelašpargo	ofelašpargo	___	___
      1 och	och	___	___
      1 oca	oca	___	___
      1 obijnân-uv	obijnân-uv	___	___
      1 oahppoplána	oahppoplána	___	___
      1 oahppamateriáladoaimmahat	oahppamateriáladoaimmahat	___	___
      1 nááijâđ	nááijâđ	___	___
      1 násttážat-konsert	násttážat-konsert	___	___
      1 nálásuš	nálásuš	___	___
      1 nálásijd	nálásijd	___	___
      1 náhđulâšvuotâ	náhđulâšvuotâ	___	___
      1 náguseh	náguseh	___	___
      1 nyevdittij	nyevdittij	___	___
      1 nuorâskoovlâst	nuorâskoovlâst	___	___
      1 nuorâmussáid	nuorâmussáid	___	___
      1 nuorâipoolitlâš	nuorâipoolitlâš	___	___
      1 nuorâipoolitliih	nuorâipoolitliih	___	___
      1 nuorttâsâmikielâlâš	nuorttâsâmikielâlâš	___	___
      1 nuorttâlâššáid	nuorttâlâššáid	___	___
      1 nuorttâlâšâid	nuorttâlâšâid	___	___
      1 nuorttâlâškatrilli	nuorttâlâškatrilli	___	___
      1 nuorttâlâškatrill	nuorttâlâškatrill	___	___
      1 nuorttâlâšah	nuorttâlâšah	___	___
      1 nuorgam	nuorgam	___	___
      1 nuorat	nuorat	___	___
      1 nubâstussáid	nubâstussáid	___	___
      1 nubás-tus	nubás-tus	___	___
      1 nubetove	nubetove	___	___
      1 nuađi	nuađi	___	___
      1 normimist	normimist	___	___
      1 noormâi	noormâi	___	___
      1 noomâttijn	noomâttijn	___	___
      1 noomâd	noomâd	___	___
      1 nomâttemmin	nomâttemmin	___	___
      1 nomâlâssâm	nomâlâssâm	___	___
      1 nommâčuágáldâpalvâlus	nommâčuágáldâpalvâlus	___	___
      1 nommâdâhpalvâlus	nommâdâhpalvâlus	___	___
      1 nmr	nmr	___	___
      1 njyebžiluđ	njyebžiluđ	___	___
      1 njuárustâllâmviestâčuoigâm–	njuárustâllâmviestâčuoigâm–	___	___
      1 njuálguvaljimnumerân	njuálguvaljimnumerân	___	___
      1 njuálguvaljimnu-merân	njuálguvaljimnu-merân	___	___
      1 njuolgâluuhâmohjelmid	njuolgâluuhâmohjelmid	___	___
      1 njunnošeh	njunnošeh	___	___
      1 njunnoos	njunnoos	___	___
      1 njollâäigi	njollâäigi	___	___
      1 njaalgâhajâsijd	njaalgâhajâsijd	___	___
      1 nisson	nisson	___	___
      1 niittyvuopio	niittyvuopio	___	___
      1 neurologia	neurologia	___	___
      1 nettičujottâsâ	nettičujottâsâ	___	___
      1 nettisiiđoh	nettisiiđoh	___	___
      1 neeljikielâsâš	neeljikielâsâš	___	___
      1 navcâttemvuotâ	navcâttemvuotâ	___	___
      1 nannaamist	nannaamist	___	___
      1 naanoot	naanoot	___	___
      1 mättimijnis	mättimijnis	___	___
      1 mätkiorniimijn	mätkiorniimijn	___	___
      1 máá	máá	___	___
      1 máttáátâspargojuávhu	máttáátâspargojuávhu	___	___
      1 máttáátâsminister	máttáátâsminister	___	___
      1 máttáátâslâš	máttáátâslâš	___	___
      1 máttáátâskuávdážân	máttáátâskuávdážân	___	___
      1 máttáátâskuávdáást	máttáátâskuávdáást	___	___
      1 máttááttâsâsân	máttááttâsâsân	___	___
      1 máttááttâsâstŠ	máttááttâsâstŠ	___	___
      1 máttááttâsvyehhin	máttááttâsvyehhin	___	___
      1 máttááttâsvuávámnoormâi	máttááttâsvuávámnoormâi	___	___
      1 máttááttâsorniimijn	máttááttâsorniimijn	___	___
      1 máttááttâshaldâttâsáin	máttááttâshaldâttâsáin	___	___
      1 mánát	mánát	___	___
      1 máksučonâsmij	máksučonâsmij	___	___
      1 máidnasatŠ	máidnasatŠ	___	___
      1 muštottimčaalâ	muštottimčaalâ	___	___
      1 muštottemčálusijd	muštottemčálusijd	___	___
      1 muštokonseertist	muštokonseertist	___	___
      1 muččâdup	muččâdup	___	___
      1 muáddilov	muáddilov	___	___
      1 muusil	muusil	___	___
      1 muusikŠ	muusikŠ	___	___
      1 muusikkeejâdmâspeivi	muusikkeejâdmâspeivi	___	___
      1 muusikfestivaalâin	muusikfestivaalâin	___	___
      1 muttuustellee	muttuustellee	___	___
      1 mutta	mutta	___	___
      1 musikkistis	musikkistis	___	___
      1 musikist	musikist	___	___
      1 musijkkárijd	musijkkárijd	___	___
      1 musijkkár-niävttár	musijkkár-niävttár	___	___
      1 musiikkuávdáš	musiikkuávdáš	___	___
      1 musiikkijn	musiikkijn	___	___
      1 musiikist	musiikist	___	___
      1 munemietâmâššáin	munemietâmâššáin	___	___
      1 munemietâmâs	munemietâmâs	___	___
      1 muneldistem-	muneldistem-	___	___
      1 mp).Vuáđupäälhi	mp).Vuáđupäälhi	___	___
      1 movtijditáččij	movtijditáččij	___	___
      1 movdijtitten	movdijtitten	___	___
      1 motivistá	motivistá	___	___
      1 morruumettum	morruumettum	___	___
      1 moottoripyeráid	moottoripyeráid	___	___
      1 moottoreh	moottoreh	___	___
      1 moottoom	moottoom	___	___
      1 mooiguim	mooiguim	___	___
      1 monotoonsâšvuotâ	monotoonsâšvuotâ	___	___
      1 monikielisyyden	monikielisyyden	___	___
      1 molsâšumán	molsâšumán	___	___
      1 molsoiähtu	molsoiähtu	___	___
      1 moivášum	moivášum	___	___
      1 mohawkkielâ	mohawkkielâ	___	___
      1 mohawkijd	mohawkijd	___	___
      1 mohawk-sivnádâs	mohawk-sivnádâs	___	___
      1 mohawk	mohawk	___	___
      1 modernijd	modernijd	___	___
      1 miärádâsâid.”Čuákkim	miärádâsâid.”Čuákkim	___	___
      1 miärádâstoohâmorgaanâi	miärádâstoohâmorgaanâi	___	___
      1 miärádâssâin	miärádâssâin	___	___
      1 miärádâsrähtimprosessin	miärádâsrähtimprosessin	___	___
      1 miärádâsciälháttâsist	miärádâsciälháttâsist	___	___
      1 miäruštâllâmin	miäruštâllâmin	___	___
      1 miäruštâlluvvoo	miäruštâlluvvoo	___	___
      1 miäruštâlluvvojii	miäruštâlluvvojii	___	___
      1 miäruštâleh	miäruštâleh	___	___
      1 miärušteleh	miärušteleh	___	___
      1 miänástuvveht	miänástuvveht	___	___
      1 miäldán	miäldán	___	___
      1 miädlusmateriaalân	miädlusmateriaalân	___	___
      1 minutist	minutist	___	___
      1 minimusikaaleh	minimusikaaleh	___	___
      1 minimin	minimin	___	___
      1 min	min	___	___
      1 miksempalvâlus,*	miksempalvâlus,*	___	___
      1 mielâkuvviitâs	mielâkuvviitâs	___	___
      1 mielâkivviivâšvuođâ	mielâkivviivâšvuođâ	___	___
      1 mieddei	mieddei	___	___
      1 meän	meän	___	___
      1 mettááttâsâst	mettááttâsâst	___	___
      1 mettedmettum	mettedmettum	___	___
      1 merkonomeh	merkonomeh	___	___
      1 merkkâlinjâš	merkkâlinjâš	___	___
      1 merkkâlinjáá	merkkâlinjáá	___	___
      1 meriduvá	meriduvá	___	___
      1 meridemváldálâš	meridemváldálâš	___	___
      1 meridemnáál	meridemnáál	___	___
      1 merhâsuumijn	merhâsuumijn	___	___
      1 mekanismeh	mekanismeh	___	___
      1 meiddi	meiddi	___	___
      1 meerjhâš	meerjhâš	___	___
      1 mee-suh	mee-suh	___	___
      1 meddâlvarrmij	meddâlvarrmij	___	___
      1 meddei	meddei	___	___
      1 mašinistum	mašinistum	___	___
      1 mađhâšâdâm	mađhâšâdâm	___	___
      1 mattááttâs	mattááttâs	___	___
      1 mattáátteijeeh	mattáátteijeeh	___	___
      1 materiaapaŋkkisiijđoh	materiaapaŋkkisiijđoh	___	___
      1 materiaalâiguin	materiaalâiguin	___	___
      1 massatuurismčuásáttuv	massatuurismčuásáttuv	___	___
      1 markkânistemhaavân	markkânistemhaavân	___	___
      1 markkâniis-tuuškuottum	markkâniis-tuuškuottum	___	___
      1 maksimkukkodâh	maksimkukkodâh	___	___
      1 majepaargâ	majepaargâ	___	___
      1 majebargeehid	majebargeehid	___	___
      1 maj	maj	___	___
      1 mainâsâš	mainâsâš	___	___
      1 maigijn	maigijn	___	___
      1 mahđulâš	mahđulâš	___	___
      1 mahđulij	mahđulij	___	___
      1 madârvaanhimjn	madârvaanhimjn	___	___
      1 maaŋgâtooimâsalist	maaŋgâtooimâsalist	___	___
      1 maaŋgâtooimâsali	maaŋgâtooimâsali	___	___
      1 maaŋgâtooimâ-	maaŋgâtooimâ-	___	___
      1 maaŋgâtoimâvisteh	maaŋgâtoimâvisteh	___	___
      1 maaŋgâtoimâsajeh	maaŋgâtoimâsajeh	___	___
      1 maaŋgâsuárgásâš	maaŋgâsuárgásâš	___	___
      1 maaŋgânálásâšvuođâst	maaŋgânálásâšvuođâst	___	___
      1 maaŋgânálásâšvuođâ	maaŋgânálásâšvuođâ	___	___
      1 maaŋgâmuđušijd	maaŋgâmuđušijd	___	___
      1 maaŋgâmeerhâšlâš	maaŋgâmeerhâšlâš	___	___
      1 maaŋgâkameravuáháduv	maaŋgâkameravuáháduv	___	___
      1 maaŋgâhámásâšvuođâpoli	maaŋgâhámásâšvuođâpoli	___	___
      1 maaŋgâhámásâšvuođâpo-‐	maaŋgâhámásâšvuođâpo-‐	___	___
      1 maasâdvarrim	maasâdvarrim	___	___
      1 maasâdkesimist	maasâdkesimist	___	___
      1 maasâd-kesimist	maasâd-kesimist	___	___
      1 maantieto	maantieto	___	___
      1 maangâpiälásâžžân	maangâpiälásâžžân	___	___
      1 maallijn	maallijn	___	___
      1 maailmvijđásâš	maailmvijđásâš	___	___
      1 maailmmuusiik	maailmmuusiik	___	___
      1 maagisiih	maagisiih	___	___
      1 maadâbeln	maadâbeln	___	___
      1 maaaŋgâhámásâš	maaaŋgâhámásâš	___	___
      1 läđđeemáccuháid	läđđeemáccuháid	___	___
      1 lääcciđ	lääcciđ	___	___
      1 lävdikudijn	lävdikudijn	___	___
      1 láččoo	láččoo	___	___
      1 lááccám	lááccám	___	___
      1 lávástâlmin	lávástâlmin	___	___
      1 lávástâllâđ	lávástâllâđ	___	___
      1 lávtástâllâmoornig	lávtástâllâmoornig	___	___
      1 lávtástâllâm-	lávtástâllâm-	___	___
      1 lávlá	lávlá	___	___
      1 lávlumvistááš	lávlumvistááš	___	___
      1 lávlon	lávlon	___	___
      1 lávdástâlmijnis	lávdástâlmijnis	___	___
      1 lávdástâllâmân	lávdástâllâmân	___	___
      1 lávdástâllâmkaarvuid	lávdástâllâmkaarvuid	___	___
      1 lávdástâllâm-	lávdástâllâm-	___	___
      1 lávdástâldijn	lávdástâldijn	___	___
      1 lávdástmeh	lávdástmeh	___	___
      1 lávdástiđ	lávdástiđ	___	___
      1 lávdástemvuáttámušâid	lávdástemvuáttámušâid	___	___
      1 lávdástemij	lávdástemij	___	___
      1 lávdástellen	lávdástellen	___	___
      1 lávdástelleid	lávdástelleid	___	___
      1 lávdásteh	lávdásteh	___	___
      1 láh	láh	___	___
      1 lyseo	lyseo	___	___
      1 lyevesuunnâttâllâm	lyevesuunnâttâllâm	___	___
      1 lyetittetteht	lyetittetteht	___	___
      1 luávkkudemtáárbu	luávkkudemtáárbu	___	___
      1 luándutijpâid	luándutijpâid	___	___
      1 luándulâs	luándulâs	___	___
      1 luándualdasii	luándualdasii	___	___
      1 luán-dustis	luán-dustis	___	___
      1 luán-duriggoduvâi	luán-duriggoduvâi	___	___
      1 luáigusijd	luáigusijd	___	___
      1 luuvân	luuvân	___	___
      1 luuhâmnáálá	luuhâmnáálá	___	___
      1 luovâscelkkimistis	luovâscelkkimistis	___	___
      1 luokái	luokái	___	___
      1 luokkáid	luokkáid	___	___
      1 luokittâs	luokittâs	___	___
      1 luokittâllâđ	luokittâllâđ	___	___
      1 luokittâllâm-	luokittâllâm-	___	___
      1 luokittâllojeh	luokittâllojeh	___	___
      1 luohti	luohti	___	___
      1 lundui	lundui	___	___
      1 luhostuččij	luhostuččij	___	___
      1 luandu	luandu	___	___
      1 lovottuvai	lovottuvai	___	___
      1 loveivvááš	loveivvááš	___	___
      1 loppâprosessáid	loppâprosessáid	___	___
      1 loppuseminaarissa	loppuseminaarissa	___	___
      1 loopast	loopast	___	___
      1 lonástâssân	lonástâssân	___	___
      1 lonestemnáál	lonestemnáál	___	___
      1 lojesumos	lojesumos	___	___
      1 lohtâsâm	lohtâsâm	___	___
      1 lohtâsiđ	lohtâsiđ	___	___
      1 lohtâsii	lohtâsii	___	___
      1 lohomiärálávt	lohomiärálávt	___	___
      1 liŋkki	liŋkki	___	___
      1 livđest	livđest	___	___
      1 livestream-nettivuolgâttâs	livestream-nettivuolgâttâs	___	___
      1 live-fiäránân	live-fiäránân	___	___
      1 linjâš	linjâš	___	___
      1 linjáámijd	linjáámijd	___	___
      1 line	line	___	___
      1 lijkkuustuttii	lijkkuustuttii	___	___
      1 lijkkuustuttee	lijkkuustuttee	___	___
      1 lij	lij	___	___
      1 liitto	liitto	___	___
      1 liinkâ	liinkâ	___	___
      1 liinjáh	liinjáh	___	___
      1 liidni	liidni	___	___
      1 lihâstumläädist	lihâstumläädist	___	___
      1 lieggâsin	lieggâsin	___	___
      1 li	li	___	___
      1 leuŠddân	leuŠddân	___	___
      1 leuŠddist	leuŠddist	___	___
      1 leuddŠ	leuddŠ	___	___
      1 leu	leu	___	___
      1 lekkâmsavâstis	lekkâmsavâstis	___	___
      1 leibikoVli	leibikoVli	___	___
      1 lehâstuvvii	lehâstuvvii	___	___
      1 legendaarisâš	legendaarisâš	___	___
      1 lavlun	lavlun	___	___
      1 lavdastâllâmsajeh	lavdastâllâmsajeh	___	___
      1 laura	laura	___	___
      1 lasânij	lasânij	___	___
      1 lasijttáá	lasijttáá	___	___
      1 lasettuvojeh	lasettuvojeh	___	___
      1 lasetiđuh	lasetiđuh	___	___
      1 languages	languages	___	___
      1 language	language	___	___
      1 lan	lan	___	___
      1 laiti	laiti	___	___
      1 lahânumástusâi	lahânumástusâi	___	___
      1 lahâasâttemubâlâsvuotâ	lahâasâttemubâlâsvuotâ	___	___
      1 lahtosijdisguin	lahtosijdisguin	___	___
      1 laajišsuávvááh	laajišsuávvááh	___	___
      1 laajišsuávváid	laajišsuávváid	___	___
      1 laajišsuávvái	laajišsuávvái	___	___
      1 kéha-	kéha-	___	___
      1 käärvis	käärvis	___	___
      1 kässeekeđgikirjejum	kässeekeđgikirjejum	___	___
      1 kárášjuvâlâš	kárášjuvâlâš	___	___
      1 kárvánâš	kárvánâš	___	___
      1 kárvánâm	kárvánâm	___	___
      1 kárvánmist	kárvánmist	___	___
      1 kárvuinán	kárvuinán	___	___
      1 kárvudeteh	kárvudeteh	___	___
      1 káiđuspargon	káiđuspargon	___	___
      1 káiđusmáttáátâs	káiđusmáttáátâs	___	___
      1 káiđusmáttááttâs	káiđusmáttááttâs	___	___
      1 káidusin	káidusin	___	___
      1 kyyskee	kyyskee	___	___
      1 kyskee	kyskee	___	___
      1 kyeđđih	kyeđđih	___	___
      1 kyevtpiäivásâš	kyevtpiäivásâš	___	___
      1 kyevtpiäivásii	kyevtpiäivásii	___	___
      1 kyevtiuásásâš	kyevtiuásásâš	___	___
      1 kyevtimuddosâš	kyevtimuddosâš	___	___
      1 kyevtilov	kyevtilov	___	___
      1 kyevt-	kyevt-	___	___
      1 kyeliráájjun	kyeliráájjun	___	___
      1 kyehtipiäivásâžžân	kyehtipiäivásâžžân	___	___
      1 kyehtipiäivásâš	kyehtipiäivásâš	___	___
      1 kyeddimnáál	kyeddimnáál	___	___
      1 kyeddidääigi	kyeddidääigi	___	___
      1 kyeddidkuávlu	kyeddidkuávlu	___	___
      1 kyeddidkuávloidis	kyeddidkuávloidis	___	___
      1 kyeddid	kyeddid	___	___
      1 kuškâdemnáál	kuškâdemnáál	___	___
      1 kuáškánjâs	kuáškánjâs	___	___
      1 kuáđuškuot	kuáđuškuot	___	___
      1 kuáđuttettee	kuáđuttettee	___	___
      1 kuávlupoolitliih	kuávlupoolitliih	___	___
      1 kuávluhaldâ	kuávluhaldâ	___	___
      1 kuálástemnáál	kuálástemnáál	___	___
      1 kuálttuurkuávdáš	kuálttuurkuávdáš	___	___
      1 kuáhtájep	kuáhtájep	___	___
      1 kuáduttem	kuáduttem	___	___
      1 kuulmâkielâliih	kuulmâkielâliih	___	___
      1 kuulmáin	kuulmáin	___	___
      1 kuullâmvuáháduvvâid	kuullâmvuáháduvvâid	___	___
      1 kuulluđ	kuulluđ	___	___
      1 kuulluuttem	kuulluuttem	___	___
      1 kuttemmáhđulâšvuođah	kuttemmáhđulâšvuođah	___	___
      1 kuođâid	kuođâid	___	___
      1 kuovâ-njuhčâmáánust	kuovâ-njuhčâmáánust	___	___
      1 kuovsâkkâsteatterist	kuovsâkkâsteatterist	___	___
      1 kuovsâkkâsprojektio	kuovsâkkâsprojektio	___	___
      1 kuorâttâllâmnáál	kuorâttâllâmnáál	___	___
      1 kuorolavlod	kuorolavlod	___	___
      1 kuoimijdsân	kuoimijdsân	___	___
      1 kultuur	kultuur	___	___
      1 kulttuurâst	kulttuurâst	___	___
      1 kulttuurárbáin	kulttuurárbáin	___	___
      1 kulttuurtuávváá	kulttuurtuávváá	___	___
      1 kulttuurpyevtitteeijeeluámáttuv	kulttuurpyevtitteeijeeluámáttuv	___	___
      1 kulttuurpolitiikâst	kulttuurpolitiikâst	___	___
      1 kulttuurohjem	kulttuurohjem	___	___
      1 kulttuurnalliis	kulttuurnalliis	___	___
      1 kulttuurmiäldásij	kulttuurmiäldásij	___	___
      1 kulttuurkuávđáá	kulttuurkuávđáá	___	___
      1 kulttuurkuávdás	kulttuurkuávdás	___	___
      1 kulttuurkavalgaad	kulttuurkavalgaad	___	___
      1 kulttuurherkis	kulttuurherkis	___	___
      1 kulttuur-kuávdás	kulttuur-kuávdás	___	___
      1 kulttuulâš	kulttuulâš	___	___
      1 kult-tuur-	kult-tuur-	___	___
      1 kullumvuođâ	kullumvuođâ	___	___
      1 kullekoldem	kullekoldem	___	___
      1 kulgâdâhviärmáin	kulgâdâhviärmáin	___	___
      1 kuldâlemnáál	kuldâlemnáál	___	___
      1 kukáid	kukáid	___	___
      1 kuittâđ	kuittâđ	___	___
      1 kuittag	kuittag	___	___
      1 kufittárij-uv	kufittárij-uv	___	___
      1 kufittáreh	kufittáreh	___	___
      1 kuevti	kuevti	___	___
      1 ks	ks	___	___
      1 kriittisâžžân	kriittisâžžân	___	___
      1 kriittisâš	kriittisâš	___	___
      1 kriisi-	kriisi-	___	___
      1 koččâmâšáid	koččâmâšáid	___	___
      1 koččâmušain	koččâmušain	___	___
      1 koččee	koččee	___	___
      1 kovetaaiđâr	kovetaaiđâr	___	___
      1 kovetaaidâreh	kovetaaidâreh	___	___
      1 koskâvuođâlâs	koskâvuođâlâs	___	___
      1 koskâsâs	koskâsâs	___	___
      1 koskâsvuođâst	koskâsvuođâst	___	___
      1 koskâstuárusâš	koskâstuárusâš	___	___
      1 koskâmiärálâš	koskâmiärálâš	___	___
      1 koolgap	koolgap	___	___
      1 kontekstuaallâš	kontekstuaallâš	___	___
      1 konsultaatioid	konsultaatioid	___	___
      1 konserttijd	konserttijd	___	___
      1 kongresäššigâšâi	kongresäššigâšâi	___	___
      1 kongressáid	kongressáid	___	___
      1 konfereensâid	konfereensâid	___	___
      1 kommunikaatioáárvu	kommunikaatioáárvu	___	___
      1 kolonisaatiost	kolonisaatiost	___	___
      1 kollimis	kollimis	___	___
      1 kolliimeh	kolliimeh	___	___
      1 koijâdâllâmân	koijâdâllâmân	___	___
      1 koijâdâllâmluámátuv	koijâdâllâmluámátuv	___	___
      1 koijuduvvoo	koijuduvvoo	___	___
      1 kohtâluvvojeh	kohtâluvvojeh	___	___
      1 kohtulâš	kohtulâš	___	___
      1 kodetähtikávnuseh	kodetähtikávnuseh	___	___
      1 kodepivdost	kodepivdost	___	___
      1 klassisâš	klassisâš	___	___
      1 kištottiđ	kištottiđ	___	___
      1 kištottemnjuolgâdusâin	kištottemnjuolgâdusâin	___	___
      1 kištoot	kištoot	___	___
      1 kiđđuu	kiđđuu	___	___
      1 kiäsádâdâi	kiäsádâdâi	___	___
      1 kiässeid	kiässeid	___	___
      1 kiärdoonáál	kiärdoonáál	___	___
      1 kitmân	kitmân	___	___
      1 kirkkosiidjân	kirkkosiidjân	___	___
      1 kirkkolavlud	kirkkolavlud	___	___
      1 kirjekooverttist	kirjekooverttist	___	___
      1 kildin-	kildin-	___	___
      1 kiirho	kiirho	___	___
      1 kiijtosin	kiijtosin	___	___
      1 kieđâvuššâjeh	kieđâvuššâjeh	___	___
      1 kieđâvušmettum	kieđâvušmettum	___	___
      1 kieđavuš	kieđavuš	___	___
      1 kietâčálusân	kietâčálusân	___	___
      1 kietâsuottâs	kietâsuottâs	___	___
      1 kielâtieđâldeijee	kielâtieđâldeijee	___	___
      1 kielânormim	kielânormim	___	___
      1 kielâläđvdikode	kielâläđvdikode	___	___
      1 kielâlávguumin	kielâlávguumin	___	___
      1 kielâlahâasâttâmân	kielâlahâasâttâmân	___	___
      1 kielâlaahâŠ	kielâlaahâŠ	___	___
      1 kielâkevttimaareen	kielâkevttimaareen	___	___
      1 kielâjuávusijd	kielâjuávusijd	___	___
      1 kielâiäláskitmist	kielâiäláskitmist	___	___
      1 kielâiâláskittemehidân	kielâiâláskittemehidân	___	___
      1 kieli	kieli	___	___
      1 kieldâh	kieldâh	___	___
      1 kieldstiivrâ	kieldstiivrâ	___	___
      1 kieldimkeežild	kieldimkeežild	___	___
      1 kiela	kiela	___	___
      1 kevt-‐	kevt-‐	___	___
      1 kevt-tih	kevt-tih	___	___
      1 keskus	keskus	___	___
      1 kerdiluándusiih	kerdiluándusiih	___	___
      1 keraamisâš	keraamisâš	___	___
      1 keellijd	keellijd	___	___
      1 keelijdmettumvuođâst	keelijdmettumvuođâst	___	___
      1 kavnuučij	kavnuučij	___	___
      1 kavnoo	kavnoo	___	___
      1 karttâmluoppâđ	karttâmluoppâđ	___	___
      1 kannattemvuotâ	kannattemvuotâ	___	___
      1 kanien	kanien	___	___
      1 kangasniemi	kangasniemi	___	___
      1 kaarta	kaarta	___	___
      1 ka-	ka-	___	___
      1 jävilenâmeh	jävilenâmeh	___	___
      1 jyehináál	jyehináál	___	___
      1 jyegimuđušiih	jyegimuđušiih	___	___
      1 juávkkučáitálmâsâin	juávkkučáitálmâsâin	___	___
      1 juávkkuviestâdemniävvuin	juávkkuviestâdemniävvuin	___	___
      1 juávkkuviestâdemniävvuid	juávkkuviestâdemniävvuid	___	___
      1 juávhoh	juávhoh	___	___
      1 juáigusetno	juáigusetno	___	___
      1 juáigumärbivuohân	juáigumärbivuohân	___	___
      1 juáigum	juáigum	___	___
      1 juáhhást	juáhhást	___	___
      1 juuđâš	juuđâš	___	___
      1 juuriidlâš-haaldâšlâš	juuriidlâš-haaldâšlâš	___	___
      1 juurdâštijn	juurdâštijn	___	___
      1 juridilávt	juridilávt	___	___
      1 jurgâlen	jurgâlen	___	___
      1 jurdâččin	jurdâččin	___	___
      1 jur-duu	jur-duu	___	___
      1 juoigust	juoigust	___	___
      1 juoigusijn	juoigusijn	___	___
      1 juoigeid	juoigeid	___	___
      1 julgâštuš	julgâštuš	___	___
      1 julgáštušân	julgáštušân	___	___
      1 julgáštusâst	julgáštusâst	___	___
      1 julevsämikielâ	julevsämikielâ	___	___
      1 julev-	julev-	___	___
      1 juhlepihtâsin	juhlepihtâsin	___	___
      1 juhlemusikkist	juhlemusikkist	___	___
      1 juhlecájáttâs	juhlecájáttâs	___	___
      1 juavkkupargopitah	juavkkupargopitah	___	___
      1 jođetteijeee	jođetteijeee	___	___
      1 jođetmist	jođetmist	___	___
      1 journalistlinjá	journalistlinjá	___	___
      1 journalistin	journalistin	___	___
      1 jotonpieijâmân	jotonpieijâmân	___	___
      1 jotonpieijâmist	jotonpieijâmist	___	___
      1 joođeettijn	joođeettijn	___	___
      1 jogo	jogo	___	___
      1 jiänusin	jiänusin	___	___
      1 jieštuđâváin	jieštuđâváin	___	___
      1 jieškiäs-uv	jieškiäs-uv	___	___
      1 jieškielâlii	jieškielâlii	___	___
      1 jiešhaaldâtlijd	jiešhaaldâtlijd	___	___
      1 jieŋŋâlmittojeh	jieŋŋâlmittojeh	___	___
      1 jieskote-uv	jieskote-uv	___	___
      1 jieskii-uv	jieskii-uv	___	___
      1 jiejiâs	jiejiâs	___	___
      1 jie	jie	___	___
      1 jelmân	jelmân	___	___
      1 jakutialii	jakutialii	___	___
      1 jagiáiggit	jagiáiggit	___	___
      1 j):st	j):st	___	___
      1 iävtuttâsâsâin	iävtuttâsâsâin	___	___
      1 iävtuttâsâsid	iävtuttâsâsid	___	___
      1 iävtuttâsis	iävtuttâsis	___	___
      1 iävtukkâsasâttemist	iävtukkâsasâttemist	___	___
      1 iälättâshäämi	iälättâshäämi	___	___
      1 iäláskittâm	iäláskittâm	___	___
      1 iälás-‐	iälás-‐	___	___
      1 iälákittemohjelm	iälákittemohjelm	___	___
      1 iäigádušeh	iäigádušeh	___	___
      1 iáruttuvá	iáruttuvá	___	___
      1 ivá	ivá	___	___
      1 irâttâssponsorij	irâttâssponsorij	___	___
      1 irja	irja	___	___
      1 iptoos	iptoos	___	___
      1 internetpargopitah	internetpargopitah	___	___
      1 instrumentaalmuusik	instrumentaalmuusik	___	___
      1 instrumentaallâš	instrumentaallâš	___	___
      1 instituutâst	instituutâst	___	___
      1 insestkuávdáá	insestkuávdáá	___	___
      1 innovatiivlijd	innovatiivlijd	___	___
      1 infosaje	infosaje	___	___
      1 infoost	infoost	___	___
      1 indigenous	indigenous	___	___
      1 inari	inari	___	___
      1 imâštutij	imâštutij	___	___
      1 imâšijd	imâšijd	___	___
      1 immuuneh	immuuneh	___	___
      1 imago	imago	___	___
      1 ilmoittautumislomake	ilmoittautumislomake	___	___
      1 ilmari	ilmari	___	___
      1 ijâstâllâmriâttâsâin	ijâstâllâmriâttâsâin	___	___
      1 ijastâllâđ	ijastâllâđ	___	___
      1 ija	ija	___	___
      1 ietimielâlávt-uv	ietimielâlávt-uv	___	___
      1 idja	idja	___	___
      1 identiteettâs	identiteettâs	___	___
      1 idealuándusâžžân	idealuándusâžžân	___	___
      1 ibbeerdman	ibbeerdman	___	___
      1 hämmejuumist	hämmejuumist	___	___
      1 háámáid	háámáid	___	___
      1 háálus	háálus	___	___
      1 hávdájáin-uv	hávdájáin-uv	___	___
      1 hávdájái	hávdájái	___	___
      1 hávdd	hávdd	___	___
      1 hástušijd	hástušijd	___	___
      1 hárjánelaseh	hárjánelaseh	___	___
      1 hárjut	hárjut	___	___
      1 hámášui	hámášui	___	___
      1 hyeneht	hyeneht	___	___
      1 huššááš	huššááš	___	___
      1 huápumus	huápumus	___	___
      1 huámášuvá	huámášuvá	___	___
      1 huámášuttâm	huámášuttâm	___	___
      1 huámášitteht	huámášitteht	___	___
      1 huolâttis	huolâttis	___	___
      1 hum	hum	___	___
      1 hukás	hukás	___	___
      1 hoittámnáál	hoittámnáál	___	___
      1 hiäđukoccen	hiäđukoccen	___	___
      1 hiäjuusmân	hiäjuusmân	___	___
      1 hiäjusmitteđ	hiäjusmitteđ	___	___
      1 hiäjusmitmijd-uv	hiäjusmitmijd-uv	___	___
      1 hiäjusmitmijd	hiäjusmitmijd	___	___
      1 hiäjuskannattemvuotâ	hiäjuskannattemvuotâ	___	___
      1 hiä-jusmittem	hiä-jusmittem	___	___
      1 historjáhliih	historjáhliih	___	___
      1 hirmâdâsräppin	hirmâdâsräppin	___	___
      1 hiphopin	hiphopin	___	___
      1 hilgojuvvojeh	hilgojuvvojeh	___	___
      1 herbaarion	herbaarion	___	___
      1 hepâmâššâđ	hepâmâššâđ	___	___
      1 helsinki	helsinki	___	___
      1 heivitman	heivitman	___	___
      1 heivit	heivit	___	___
      1 heiviittuvá	heiviittuvá	___	___
      1 heiviitteemeest	heiviitteemeest	___	___
      1 heavymuusikân	heavymuusikân	___	___
      1 hannu	hannu	___	___
      1 haldâšemviergeomâháin	haldâšemviergeomâháin	___	___
      1 haldâšempolitiikast	haldâšempolitiikast	___	___
      1 haldâttâsohjelmâst	haldâttâsohjelmâst	___	___
      1 haldâtliih	haldâtliih	___	___
      1 haldâsemkuávluh	haldâsemkuávluh	___	___
      1 haaldunväldim	haaldunväldim	___	___
      1 guttorm	guttorm	___	___
      1 guoláš	guoláš	___	___
      1 guol	guol	___	___
      1 gt	gt	___	___
      1 gsm	gsm	___	___
      1 gos	gos	___	___
      1 giellagáldu	giellagáldu	___	___
      1 generis-	generis-	___	___
      1 generis	generis	___	___
      1 geainnut	geainnut	___	___
      1 geaidnu	geaidnu	___	___
      1 galdu	galdu	___	___
      1 förvaltningsområdet	förvaltningsområdet	___	___
      1 förvaltningsmyndigheter	förvaltningsmyndigheter	___	___
      1 förstudieprojekt	förstudieprojekt	___	___
      1 för	för	___	___
      1 fáálám	fáálám	___	___
      1 fáttee	fáttee	___	___
      1 fálusin	fálusin	___	___
      1 fylkeskommune	fylkeskommune	___	___
      1 freelanceristám	freelanceristám	___	___
      1 forvaltningsområdet	forvaltningsområdet	___	___
      1 forgâbalij	forgâbalij	___	___
      1 for	for	___	___
      1 folkmuusik	folkmuusik	___	___
      1 folk-muusik	folk-muusik	___	___
      1 finnám	finnám	___	___
      1 finnodâtooimân	finnodâtooimân	___	___
      1 finnodâshtoimâ-	finnodâshtoimâ-	___	___
      1 finniivâšvuođâ	finniivâšvuođâ	___	___
      1 finnejuččij	finnejuččij	___	___
      1 fijnoduvâiguin	fijnoduvâiguin	___	___
      1 fiinaansčällee	fiinaansčällee	___	___
      1 fievridemeh	fievridemeh	___	___
      1 fiLuándusuojâlemjođetteijee	fiLuándusuojâlemjođetteijee	___	___
      1 fi-viärmádâhpalvâlem	fi-viärmádâhpalvâlem	___	___
      1 festi-vaal	festi-vaal	___	___
      1 ferimáid	ferimáid	___	___
      1 ferimijn	ferimijn	___	___
      1 falaldâhpivdem	falaldâhpivdem	___	___
      1 eŋgâlâs-	eŋgâlâs-	___	___
      1 eŋglâlâs-	eŋglâlâs-	___	___
      1 evrod	evrod	___	___
      1 evl	evl	___	___
      1 event	event	___	___
      1 europarlamiänttárin	europarlamiänttárin	___	___
      1 etnomusikologi	etnomusikologi	___	___
      1 etno-juávkku	etno-juávkku	___	___
      1 etno	etno	___	___
      1 essee	essee	___	___
      1 espanja-	espanja-	___	___
      1 esitemateriaal	esitemateriaal	___	___
      1 epostâ	epostâ	___	___
      1 epiohtâlâš	epiohtâlâš	___	___
      1 enâmuštáá	enâmuštáá	___	___
      1 enâduvvâin	enâduvvâin	___	___
      1 enâbáin-uv	enâbáin-uv	___	___
      1 enijhuolâttâs	enijhuolâttâs	___	___
      1 endangered	endangered	___	___
      1 elmottâtmeh	elmottâtmeh	___	___
      1 elementeh	elementeh	___	___
      1 elemeentih	elemeentih	___	___
      1 ekosysteemaldânemtäävi	ekosysteemaldânemtäävi	___	___
      1 ei	ei	___	___
      1 eestikielâ	eestikielâ	___	___
      1 eennâmoommâstmist	eennâmoommâstmist	___	___
      1 eennâmkodálâš	eennâmkodálâš	___	___
      1 eennâmkevttim-‐	eennâmkevttim-‐	___	___
      1 eennikiellânis	eennikiellânis	___	___
      1 eennantieđalaš	eennantieđalaš	___	___
      1 eennamuasi	eennamuasi	___	___
      1 eennamtiađu	eennamtiađu	___	___
      1 eeneb	eeneb	___	___
      1 eellimvuáimálâš	eellimvuáimálâš	___	___
      1 eellimvuáimálii	eellimvuáimálii	___	___
      1 eellimavveem	eellimavveem	___	___
      1 eddel	eddel	___	___
      1 e-mail	e-mail	___	___
      1 dávvisámegiella	dávvisámegiella	___	___
      1 dál	dál	___	___
      1 dáidogihpa	dáidogihpa	___	___
      1 dáiddadáhpáhus	dáiddadáhpáhus	___	___
      1 duodji	duodji	___	___
      1 domstolar	domstolar	___	___
      1 digitistmáin	digitistmáin	___	___
      1 digitaalteddilâssân	digitaalteddilâssân	___	___
      1 digiháámán	digiháámán	___	___
      1 diagraamai	diagraamai	___	___
      1 deebyytskiärru	deebyytskiärru	___	___
      1 de	de	___	___
      1 ddejeijee	ddejeijee	___	___
      1 davvisámegiella	davvisámegiella	___	___
      1 datanomeh	datanomeh	___	___
      1 da	da	___	___
      1 cájáttâsân	cájáttâsân	___	___
      1 citysämmilâš	citysämmilâš	___	___
      1 caittâleijee-toimâtteijee	caittâleijee-toimâtteijee	___	___
      1 bändijn	bändijn	___	___
      1 bártni	bártni	___	___
      1 bánna	bánna	___	___
      1 by	by	___	___
      1 busuk	busuk	___	___
      1 buorttâlâšâi	buorttâlâšâi	___	___
      1 budjetistâm	budjetistâm	___	___
      1 bud-jetiävtuttâsân	bud-jetiävtuttâsân	___	___
      1 bruttoneljihâšmeetter	bruttoneljihâšmeetter	___	___
      1 brm2	brm2	___	___
      1 brm	brm	___	___
      1 boagán	boagán	___	___
      1 blues	blues	___	___
      1 birra	birra	___	___
      1 biotorvolâšvuođâpevdikirje	biotorvolâšvuođâpevdikirje	___	___
      1 biodversiteetstrategiah	biodversiteetstrategiah	___	___
      1 biodiversiteettân	biodiversiteettân	___	___
      1 biodiversiteetstratergia-	biodiversiteetstratergia-	___	___
      1 band	band	___	___
      1 bajeuáppeetutkosijn	bajeuáppeetutkosijn	___	___
      1 backstage	backstage	___	___
      1 bachelori	bachelori	___	___
      1 avun*	avun*	___	___
      1 avun	avun	___	___
      1 av-pyevtittâsriäiduiguin	av-pyevtittâsriäiduiguin	___	___
      1 aulan	aulan	___	___
      1 at)gmail.com	at)gmail.com	___	___
      1 asâtem	asâtem	___	___
      1 asâstâllâđ	asâstâllâđ	___	___
      1 asattâs	asattâs	___	___
      1 arvuštallampargopitah	arvuštallampargopitah	___	___
      1 arttân	arttân	___	___
      1 arttâ	arttâ	___	___
      1 artiseh	artiseh	___	___
      1 artiklân	artiklân	___	___
      1 arktâlâs	arktâlâs	___	___
      1 arkkâdâhlágádâssâin	arkkâdâhlágádâssâin	___	___
      1 arkkitáámmát	arkkitáámmát	___	___
      1 arkkitehtuuris	arkkitehtuuris	___	___
      1 arkkitehtuurikišto	arkkitehtuurikišto	___	___
      1 arkkitehtuur	arkkitehtuur	___	___
      1 arkkitehtitoimâttuv	arkkitehtitoimâttuv	___	___
      1 arkkitehlávt	arkkitehlávt	___	___
      1 arikkâl	arikkâl	___	___
      1 argâpihtâsin	argâpihtâsin	___	___
      1 areena	areena	___	___
      1 ardesaaneh	ardesaaneh	___	___
      1 arabiakielâ	arabiakielâ	___	___
      1 approbatur	approbatur	___	___
      1 använda	använda	___	___
      1 ansulávt	ansulávt	___	___
      1 anneli	anneli	___	___
      1 animaatiokuálusist	animaatiokuálusist	___	___
      1 animaatioelleekuuvijn	animaatioelleekuuvijn	___	___
      1 anarâškielâtáiđusiih	anarâškielâtáiđusiih	___	___
      1 amnâshaaldâšlijd	amnâshaaldâšlijd	___	___
      1 amnâshaaldâtlij	amnâshaaldâtlij	___	___
      1 amnasij	amnasij	___	___
      1 alv	alv	___	___
      1 alueella	alueella	___	___
      1 alnetoolâmân	alnetoolâmân	___	___
      1 alnetoollâm	alnetoollâm	___	___
      1 almug	almug	___	___
      1 almostitteđ	almostitteđ	___	___
      1 almossopâmušnr	almossopâmušnr	___	___
      1 almoost	almoost	___	___
      1 almolâs	almolâs	___	___
      1 alkoholismânjá	alkoholismânjá	___	___
      1 alias	alias	___	___
      1 algâmáttáátâs	algâmáttáátâs	___	___
      1 algâaalmugsiärvusijntuođâlijd	algâaalmugsiärvusijntuođâlijd	___	___
      1 algâaalmugjulgáštušâst	algâaalmugjulgáštušâst	___	___
      1 algáaalmugij	algáaalmugij	___	___
      1 algaprojeekt	algaprojeekt	___	___
      1 aldâpirrâs	aldâpirrâs	___	___
      1 aldá	aldá	___	___
      1 aldelee	aldelee	___	___
      1 aldažin	aldažin	___	___
      1 aldamáttááttâsân	aldamáttááttâsân	___	___
      1 aldamáttááttâsteivâdem	aldamáttááttâsteivâdem	___	___
      1 akustilâš	akustilâš	___	___
      1 akryyltuálbusáid	akryyltuálbusáid	___	___
      1 ajosist	ajosist	___	___
      1 aitâr	aitâr	___	___
      1 aikio-puoskari	aikio-puoskari	___	___
      1 aigipaje	aigipaje	___	___
      1 aigikyevdilis	aigikyevdilis	___	___
      1 addeleh	addeleh	___	___
      1 acappella	acappella	___	___
      1 aašijdis	aašijdis	___	___
      1 aatoomruustigijd	aatoomruustigijd	___	___
      1 aasâđ	aasâđ	___	___
      1 aasâttijn	aasâttijn	___	___
      1 aarâhšoddâdem	aarâhšoddâdem	___	___
      1 aartâin	aartâin	___	___
      1 aareen	aareen	___	___
      1 aapis	aapis	___	___
      1 aanaarsämikilâlâš	aanaarsämikilâlâš	___	___
      1 aalmugtiervâsvuođâkonfereensâst	aalmugtiervâsvuođâkonfereensâst	___	___
      1 aalmgugij-koskâsâš	aalmgugij-koskâsâš	___	___
      1 Zolutuhina	Zolutuhina	___	___
      1 Zaharov	Zaharov	___	___
      1 Your	Your	___	___
      1 Yellowknifân	Yellowknifân	___	___
      1 Working	Working	___	___
      1 Wiljamist	Wiljamist	___	___
      1 Wilhem	Wilhem	___	___
      1 Weissenberg	Weissenberg	___	___
      1 Väridemnáál	Väridemnáál	___	___
      1 Váldukyeddid	Váldukyeddid	___	___
      1 Váldu-ilmuuh	Váldu-ilmuuh	___	___
      1 Váijuvâš	Váijuvâš	___	___
      1 Váhčir	Váhčir	___	___
      1 VÁLDUSALI	VÁLDUSALI	___	___
      1 VÁLDUAULA	VÁLDUAULA	___	___
      1 Vyelikiävŋá	Vyelikiävŋá	___	___
      1 Vyeitee	Vyeitee	___	___
      1 Vuássááh	Vuássááh	___	___
      1 Vualčere	Vualčere	___	___
      1 Votkaturistit	Votkaturistit	___	___
      1 Voice	Voice	___	___
      1 Vistádâhân	Vistádâhân	___	___
      1 Vistáduvvâst	Vistáduvvâst	___	___
      1 Visitinari	Visitinari	___	___
      1 Virgálâs	Virgálâs	___	___
      1 Virgeomâhij	Virgeomâhij	___	___
      1 Villat-juávkku	Villat-juávkku	___	___
      1 Villasat	Villasat	___	___
      1 Vilddas-juávhu	Vilddas-juávhu	___	___
      1 Vilddas	Vilddas	___	___
      1 Viermimáttáátteeh	Viermimáttáátteeh	___	___
      1 Venetsia	Venetsia	___	___
      1 Veistola	Veistola	___	___
      1 Veikkausân	Veikkausân	___	___
      1 Veikkaus	Veikkaus	___	___
      1 Veddikoori	Veddikoori	___	___
      1 Vari	Vari	___	___
      1 Valvira	Valvira	___	___
      1 Valleest	Valleest	___	___
      1 Vall	Vall	___	___
      1 Vaimmus	Vaimmus	___	___
      1 VYEBDIMPALVÂLUSÂST	VYEBDIMPALVÂLUSÂST	___	___
      1 VUÁĐUHÄÄMI	VUÁĐUHÄÄMI	___	___
      1 VUÁĐU-	VUÁĐU-	___	___
      1 VIRGE	VIRGE	___	___
      1 VIDEOSTUDIO	VIDEOSTUDIO	___	___
      1 Uárnip	Uárnip	___	___
      1 Uáppásm	Uáppásm	___	___
      1 Usholik	Usholik	___	___
      1 Ulda-juávhuinis	Ulda-juávhuinis	___	___
      1 Ulda	Ulda	___	___
      1 Ucjuuvvâst	Ucjuuvvâst	___	___
      1 Uccjuvnjäälmi	Uccjuvnjäälmi	___	___
      1 Ubmi	Ubmi	___	___
      1 UUCCÂMÄÄIGI	UUCCÂMÄÄIGI	___	___
      1 U-häämist	U-häämist	___	___
      1 Törvi	Törvi	___	___
      1 Téllez	Téllez	___	___
      1 Tääm	Tääm	___	___
      1 Täsiárvuváldálâš	Täsiárvuváldálâš	___	___
      1 Täi	Täi	___	___
      1 Táid	Táid	___	___
      1 Tábáhtustekniik,*	Tábáhtustekniik,*	___	___
      1 Työkirja	Työkirja	___	___
      1 Tychuk	Tychuk	___	___
      1 Tuáiján	Tuáiján	___	___
      1 Tuvalalâš	Tuvalalâš	___	___
      1 Tsukotka	Tsukotka	___	___
      1 Touijuum	Touijuum	___	___
      1 Torsell	Torsell	___	___
      1 Torika	Torika	___	___
      1 Tohálâšvuotvátámâššân	Tohálâšvuotvátámâššân	___	___
      1 Tobdosumos	Tobdosumos	___	___
      1 Tiörv	Tiörv	___	___
      1 Tiäppánpeeivi	Tiäppánpeeivi	___	___
      1 Tiänuleve	Tiänuleve	___	___
      1 Tiänuleeveet	Tiänuleeveet	___	___
      1 Tiänujuvsopâmuš	Tiänujuvsopâmuš	___	___
      1 Titoff	Titoff	___	___
      1 Tilálâsvuođâ	Tilálâsvuođâ	___	___
      1 Tieđettemčálusijd	Tieđettemčálusijd	___	___
      1 Tiađáttâs	Tiađáttâs	___	___
      1 Teáhter	Teáhter	___	___
      1 Tehálumâš	Tehálumâš	___	___
      1 Tankaväärist	Tankaväärist	___	___
      1 Tamperelâš	Tamperelâš	___	___
      1 Taikalamppu	Taikalamppu	___	___
      1 Taija	Taija	___	___
      1 Taažâbel	Taažâbel	___	___
      1 Taaidâreh	Taaidâreh	___	___
      1 Taai-dâtábáhtusâst	Taai-dâtábáhtusâst	___	___
      1 TV-já	TV-já	___	___
      1 TUULHAH	TUULHAH	___	___
      1 TURVIIMÂN	TURVIIMÂN	___	___
      1 TOOIMÂI	TOOIMÂI	___	___
      1 TIILÁÁMVÄÄRRIDMEH	TIILÁÁMVÄÄRRIDMEH	___	___
      1 TIILÁÁMNÁÁL	TIILÁÁMNÁÁL	___	___
      1 TIERVÂSVUOĐÂPALVÂLUSÂI	TIERVÂSVUOĐÂPALVÂLUSÂI	___	___
      1 TIERVÂPUÁTTIM	TIERVÂPUÁTTIM	___	___
      1 TEIKÂ	TEIKÂ	___	___
      1 TANSSÂ	TANSSÂ	___	___
      1 TAAIĐÂTÁBÁHTUSKUUVIJD	TAAIĐÂTÁBÁHTUSKUUVIJD	___	___
      1 Säätiön	Säätiön	___	___
      1 Säätiö	Säätiö	___	___
      1 Säpmi	Säpmi	___	___
      1 Sämiáášij	Sämiáášij	___	___
      1 Sämivuástásâš	Sämivuástásâš	___	___
      1 Sämiuseo	Sämiuseo	___	___
      1 Sämiráp	Sämiráp	___	___
      1 Sämipoolitlâš	Sämipoolitlâš	___	___
      1 Sämiparlamiänttáreh	Sämiparlamiänttáreh	___	___
      1 Sämimáccuhijguin	Sämimáccuhijguin	___	___
      1 Sämikielâg	Sämikielâg	___	___
      1 Sämiarttâsâš	Sämiarttâsâš	___	___
      1 Sämiaaššijn	Sämiaaššijn	___	___
      1 Sáráhká	Sáráhká	___	___
      1 Sápmelaččat	Sápmelaččat	___	___
      1 Sámit	Sámit	___	___
      1 Sámij	Sámij	___	___
      1 Sámenuoraid	Sámenuoraid	___	___
      1 Sáfá2-haahâ	Sáfá2-haahâ	___	___
      1 SáFá-	SáFá-	___	___
      1 SÄMIMUSEO-LUÁNDUKUÁVDÁŠ	SÄMIMUSEO-LUÁNDUKUÁVDÁŠ	___	___
      1 SÄMILUOKKA	SÄMILUOKKA	___	___
      1 SÄMIKIELÂLIJ	SÄMIKIELÂLIJ	___	___
      1 SÁFÁ2-projektin	SÁFÁ2-projektin	___	___
      1 Sykkys	Sykkys	___	___
      1 Syennjilsiijdâliih	Syennjilsiijdâliih	___	___
      1 Suvikki	Suvikki	___	___
      1 Suorsil	Suorsil	___	___
      1 Stáre	Stáre	___	___
      1 Stáhtačálli	Stáhtačálli	___	___
      1 Stuorraguoika	Stuorraguoika	___	___
      1 Streaming-vuáhádâh	Streaming-vuáhádâh	___	___
      1 Stream-vuolgâttem	Stream-vuolgâttem	___	___
      1 Straejmiest	Straejmiest	___	___
      1 Stolt	Stolt	___	___
      1 Stipen-dijd	Stipen-dijd	___	___
      1 Statssekretær	Statssekretær	___	___
      1 Staatâvarij-	Staatâvarij-	___	___
      1 Staainâh-čáitálduvâst	Staainâh-čáitálduvâst	___	___
      1 Spire	Spire	___	___
      1 Sovio-Pyhälä	Sovio-Pyhälä	___	___
      1 SottiisiMoves	SottiisiMoves	___	___
      1 Soti-ornimlaahâ	Soti-ornimlaahâ	___	___
      1 Sosionomi	Sosionomi	___	___
      1 Sosiaalneuvos	Sosiaalneuvos	___	___
      1 Soofi-Uulá	Soofi-Uulá	___	___
      1 Sonkamuotka	Sonkamuotka	___	___
      1 Sombio-by	Sombio-by	___	___
      1 Soađegilli	Soađegilli	___	___
      1 Snåasa	Snåasa	___	___
      1 Skábma	Skábma	___	___
      1 Skuvlen-	Skuvlen-	___	___
      1 Skammâkoveh-elleekovefestivaal	Skammâkoveh-elleekovefestivaal	___	___
      1 Siärvušijn	Siärvušijn	___	___
      1 Siärvulâšvuotâ	Siärvulâšvuotâ	___	___
      1 Sisčääsih	Sisčääsih	___	___
      1 Sisävedet	Sisävedet	___	___
      1 Sirpa	Sirpa	___	___
      1 Sirkku	Sirkku	___	___
      1 Sinituuli	Sinituuli	___	___
      1 Sinettä	Sinettä	___	___
      1 Silbast	Silbast	___	___
      1 Silbanásti	Silbanásti	___	___
      1 Silban	Silban	___	___
      1 Sieidáid	Sieidáid	___	___
      1 Shoutbox-savâstâllâmsaje	Shoutbox-savâstâllâmsaje	___	___
      1 Shop	Shop	___	___
      1 Servodat	Servodat	___	___
      1 Senaatti-kiddoduavh	Senaatti-kiddoduavh	___	___
      1 Selvâttâsâst	Selvâttâsâst	___	___
      1 Selibatos	Selibatos	___	___
      1 Sektorkuáhtásiih	Sektorkuáhtásiih	___	___
      1 Seelandist	Seelandist	___	___
      1 Second	Second	___	___
      1 Sapmi	Sapmi	___	___
      1 Santtila	Santtila	___	___
      1 Sanomat	Sanomat	___	___
      1 Sami	Sami	___	___
      1 Sallâvääri	Sallâvääri	___	___
      1 Sajoist	Sajoist	___	___
      1 Sajanmáávsun	Sajanmáávsun	___	___
      1 Saijoosist	Saijoosist	___	___
      1 Saavâjođettemvuotâ	Saavâjođettemvuotâ	___	___
      1 Saamelaiskäräjät	Saamelaiskäräjät	___	___
      1 Saamelais-kulttuurikeskuksen	Saamelais-kulttuurikeskuksen	___	___
      1 SaKasteproojekt	SaKasteproojekt	___	___
      1 SaKaste-Sämmilij	SaKaste-Sämmilij	___	___
      1 STATEMENT	STATEMENT	___	___
      1 SPECIAL	SPECIAL	___	___
      1 SOUNDS-tábáhtusân	SOUNDS-tábáhtusân	___	___
      1 SOUNDS	SOUNDS	___	___
      1 SOSIAAL-	SOSIAAL-	___	___
      1 SOLJU	SOLJU	___	___
      1 SISTI	SISTI	___	___
      1 SILBANÁSTI	SILBANÁSTI	___	___
      1 SILBA	SILBA	___	___
      1 SIJDÂ	SIJDÂ	___	___
      1 SIIJDÂ	SIIJDÂ	___	___
      1 SEMINAARHÄÄMI	SEMINAARHÄÄMI	___	___
      1 SEMINAAR-	SEMINAAR-	___	___
      1 SAIJAASVUOTÂ	SAIJAASVUOTÂ	___	___
      1 SAAVÂJOĐETTEIJEE	SAAVÂJOĐETTEIJEE	___	___
      1 Räppär	Räppär	___	___
      1 Räjittis	Räjittis	___	___
      1 Rááidun	Rááidun	___	___
      1 Ráhkisvuođa	Ráhkisvuođa	___	___
      1 RÄI.	RÄI.	___	___
      1 Ruáivinjaargâst	Ruáivinjaargâst	___	___
      1 Ruotsast	Ruotsast	___	___
      1 Roosa	Roosa	___	___
      1 Riđđu	Riđđu	___	___
      1 Rintamamuseost	Rintamamuseost	___	___
      1 Riitan	Riitan	___	___
      1 Rendón	Rendón	___	___
      1 Rektor	Rektor	___	___
      1 Rehnáin	Rehnáin	___	___
      1 Realism	Realism	___	___
      1 Raisa	Raisa	___	___
      1 Rainein	Rainein	___	___
      1 Raine	Raine	___	___
      1 Radio-ork	Radio-ork	___	___
      1 Raajijkoskâsiih	Raajijkoskâsiih	___	___
      1 RAVVUUH	RAVVUUH	___	___
      1 RAPPORTEUR	RAPPORTEUR	___	___
      1 RAAVÂDVIÄSU	RAAVÂDVIÄSU	___	___
      1 Pärnuvuottân	Pärnuvuottân	___	___
      1 Päikkeennâm	Päikkeennâm	___	___
      1 Pyylampin	Pyylampin	___	___
      1 Pygálusâi	Pygálusâi	___	___
      1 Pygálussáid	Pygálussáid	___	___
      1 Pyeongchangist	Pyeongchangist	___	___
      1 Pusuihân	Pusuihân	___	___
      1 Prosessij	Prosessij	___	___
      1 Powerdancers	Powerdancers	___	___
      1 Povdiittâsčáitálmâsân	Povdiittâsčáitálmâsân	___	___
      1 Porsaŋg	Porsaŋg	___	___
      1 Ponku	Ponku	___	___
      1 Poliitlâš	Poliitlâš	___	___
      1 Pohjolan	Pohjolan	___	___
      1 Pohjankartano	Pohjankartano	___	___
      1 Pocatierra	Pocatierra	___	___
      1 Plaktijn	Plaktijn	___	___
      1 Piäcámân	Piäcámân	___	___
      1 Pivtâsheŋgiittâstile	Pivtâsheŋgiittâstile	___	___
      1 Piilvist	Piilvist	___	___
      1 Piibe	Piibe	___	___
      1 Piela	Piela	___	___
      1 Petraast	Petraast	___	___
      1 Peoples	Peoples	___	___
      1 Pelettisvuođâ	Pelettisvuođâ	___	___
      1 PeVM	PeVM	___	___
      1 Patton	Patton	___	___
      1 Pasilast	Pasilast	___	___
      1 Parliamentary	Parliamentary	___	___
      1 ParlamentŠ-nomâttâs	ParlamentŠ-nomâttâs	___	___
      1 Pariisist	Pariisist	___	___
      1 Pallasmaa	Pallasmaa	___	___
      1 Palkinen	Palkinen	___	___
      1 Palhešume	Palhešume	___	___
      1 Pald-paldluvâi	Pald-paldluvâi	___	___
      1 PUÁRÁSIJPARGO	PUÁRÁSIJPARGO	___	___
      1 POLURA-lahâasâttâs	POLURA-lahâasâttâs	___	___
      1 PIRÂSČÄLLEE	PIRÂSČÄLLEE	___	___
      1 PEFC-meccisertifisistemkriteerijd	PEFC-meccisertifisistemkriteerijd	___	___
      1 PARLAMENTSALI	PARLAMENTSALI	___	___
      1 PALVÂLEMVÄÄRRIDMIJD	PALVÂLEMVÄÄRRIDMIJD	___	___
      1 Ođđasat	Ođđasat	___	___
      1 Ovdebááh	Ovdebááh	___	___
      1 Ounasvaara	Ounasvaara	___	___
      1 Oulunsalo	Oulunsalo	___	___
      1 Osloost	Osloost	___	___
      1 Oskottetteht	Oskottetteht	___	___
      1 Oropeza	Oropeza	___	___
      1 Orniimijn	Orniimijn	___	___
      1 Oppamvihkoost	Oppamvihkoost	___	___
      1 Oppamvihko	Oppamvihko	___	___
      1 Oppakirje	Oppakirje	___	___
      1 Open-Ended	Open-Ended	___	___
      1 Oovtâstjottee	Oovtâstjottee	___	___
      1 Ooulust	Ooulust	___	___
      1 Oobižeh	Oobižeh	___	___
      1 Onneli	Onneli	___	___
      1 Olgoašijčällee	Olgoašijčällee	___	___
      1 Oktavuohta-siijđoin	Oktavuohta-siijđoin	___	___
      1 Ohtsâšpargo-orgaanâst	Ohtsâšpargo-orgaanâst	___	___
      1 Ohtsâspargo	Ohtsâspargo	___	___
      1 Officer	Officer	___	___
      1 Ofelašâi	Ofelašâi	___	___
      1 Ofelaš-tooimâ	Ofelaš-tooimâ	___	___
      1 Ofelaš	Ofelaš	___	___
      1 Oahptii	Oahptii	___	___
      1 Oahppoofelaš-vihko	Oahppoofelaš-vihko	___	___
      1 Oahppoofelaš-infovihko	Oahppoofelaš-infovihko	___	___
      1 OVDEDEMPEEIVIH	OVDEDEMPEEIVIH	___	___
      1 OPENING	OPENING	___	___
      1 OHCHR	OHCHR	___	___
      1 OFELAŠ	OFELAŠ	___	___
      1 Näkkäläjärven	Näkkäläjärven	___	___
      1 Näkkälist	Näkkälist	___	___
      1 Nástist	Nástist	___	___
      1 NÁSTI	NÁSTI	___	___
      1 Nuárgám	Nuárgám	___	___
      1 Nuorttâlâšâin	Nuorttâlâšâin	___	___
      1 Nuorttâlâšah	Nuorttâlâšah	___	___
      1 Nuett	Nuett	___	___
      1 Norbottenist	Norbottenist	___	___
      1 Noeli	Noeli	___	___
      1 Njuálguliŋkkâ	Njuálguliŋkkâ	___	___
      1 Njuovvan	Njuovvan	___	___
      1 Njaita	Njaita	___	___
      1 Ninjaana	Ninjaana	___	___
      1 Nimikilpailu	Nimikilpailu	___	___
      1 Nillas	Nillas	___	___
      1 Nadesha	Nadesha	___	___
      1 NUORÂ	NUORÂ	___	___
      1 Mätäsaho	Mätäsaho	___	___
      1 Máttuid	Máttuid	___	___
      1 Mánnu	Mánnu	___	___
      1 Málat	Málat	___	___
      1 Máiza-Bier	Máiza-Bier	___	___
      1 MÁNNU	MÁNNU	___	___
      1 Muštâlušah	Muštâlušah	___	___
      1 Muuštâč	Muuštâč	___	___
      1 Muumijd	Muumijd	___	___
      1 Mustikka	Mustikka	___	___
      1 Muiznieks	Muiznieks	___	___
      1 Muitalus	Muitalus	___	___
      1 Mosaiikist	Mosaiikist	___	___
      1 Moilanenân	Moilanenân	___	___
      1 Miäldusmateriaalah	Miäldusmateriaalah	___	___
      1 Mitro	Mitro	___	___
      1 Mission	Mission	___	___
      1 Minute	Minute	___	___
      1 Milja	Milja	___	___
      1 Milagro	Milagro	___	___
      1 Mikser	Mikser	___	___
      1 Miikka	Miikka	___	___
      1 Mecci-‐	Mecci-‐	___	___
      1 Materiaalah	Materiaalah	___	___
      1 María	María	___	___
      1 Marét	Marét	___	___
      1 Markkânistemtooi	Markkânistemtooi	___	___
      1 Mareena	Mareena	___	___
      1 Makreta	Makreta	___	___
      1 Maiju	Maiju	___	___
      1 Maaŋgâkameratarkkuuttâhvuáhádâh	Maaŋgâkameratarkkuuttâhvuáhádâh	___	___
      1 Maahisweb	Maahisweb	___	___
      1 Maada-	Maada-	___	___
      1 MUUSIKSTUDIO	MUUSIKSTUDIO	___	___
      1 MINIháámán	MINIháámán	___	___
      1 MINIHÄÄMI	MINIHÄÄMI	___	___
      1 MEDIALUOKKA	MEDIALUOKKA	___	___
      1 MAKSI-häämi	MAKSI-häämi	___	___
      1 MAKSI-	MAKSI-	___	___
      1 Lönn	Lönn	___	___
      1 Länsstyrelsen	Länsstyrelsen	___	___
      1 Lávtástâllâm-	Lávtástâllâm-	___	___
      1 Lávlumvistááš	Lávlumvistááš	___	___
      1 Láigulâžžáin	Láigulâžžáin	___	___
      1 Lyriikkain	Lyriikkain	___	___
      1 Lyeme-Juŋŋâ	Lyeme-Juŋŋâ	___	___
      1 Loka	Loka	___	___
      1 Lodderáidalas	Lodderáidalas	___	___
      1 Liŋkki	Liŋkki	___	___
      1 Liävnjavuonâ	Liävnjavuonâ	___	___
      1 Live-jienâtävistempalvâlusah,*	Live-jienâtävistempalvâlusah,*	___	___
      1 Liton	Liton	___	___
      1 Lisätiätu	Lisätiätu	___	___
      1 Liinu	Liinu	___	___
      1 Liede	Liede	___	___
      1 LeuŠddiđ	LeuŠddiđ	___	___
      1 LeuŠdd	LeuŠdd	___	___
      1 Lasttat	Lasttat	___	___
      1 Lasetiäiđuid	Lasetiäiđuid	___	___
      1 Lappia-táálu	Lappia-táálu	___	___
      1 Laivamaa	Laivamaa	___	___
      1 Lag	Lag	___	___
      1 Laatokkast	Laatokkast	___	___
      1 Laajišsuávváá	Laajišsuávváá	___	___
      1 Laaitin	Laaitin	___	___
      1 LUOKKAVISTEH	LUOKKAVISTEH	___	___
      1 LIVĐE	LIVĐE	___	___
      1 Kárášjohka	Kárášjohka	___	___
      1 Kyevtpiäivásâš	Kyevtpiäivásâš	___	___
      1 Kyevtiuásásâš	Kyevtiuásásâš	___	___
      1 Kuávdážist	Kuávdážist	___	___
      1 Kustan-nusosakeyhtiö	Kustan-nusosakeyhtiö	___	___
      1 Kusmin	Kusmin	___	___
      1 Kunnskapsdepartement	Kunnskapsdepartement	___	___
      1 Kulttuurohjempaŋkki	Kulttuurohjempaŋkki	___	___
      1 Kufittárkuáhtás	Kufittárkuáhtás	___	___
      1 Kriittisâš	Kriittisâš	___	___
      1 Koččâmâsâst	Koččâmâsâst	___	___
      1 Kovetaaiđâakatemiâst	Kovetaaiđâakatemiâst	___	___
      1 Koulutus-	Koulutus-	___	___
      1 Kotast	Kotast	___	___
      1 Korkalovaara	Korkalovaara	___	___
      1 Koovest	Koovest	___	___
      1 Kooverttân	Kooverttân	___	___
      1 Koltansaamen	Koltansaamen	___	___
      1 Koijâdâllâmluámátuv	Koijâdâllâmluámátuv	___	___
      1 Klimenko	Klimenko	___	___
      1 Kiuruvesi	Kiuruvesi	___	___
      1 Kirjekooverttân	Kirjekooverttân	___	___
      1 Kimmel	Kimmel	___	___
      1 Kiirunast	Kiirunast	___	___
      1 Kiia	Kiia	___	___
      1 Kielâašijčällee	Kielâašijčällee	___	___
      1 Kielipalhâšume	Kielipalhâšume	___	___
      1 Kielikylvyn	Kielikylvyn	___	___
      1 Keisarinna	Keisarinna	___	___
      1 Keisarin	Keisarin	___	___
      1 Kavpugist	Kavpugist	___	___
      1 Katajamaa	Katajamaa	___	___
      1 Kanien	Kanien	___	___
      1 Kander	Kander	___	___
      1 Kaitsalo	Kaitsalo	___	___
      1 Kahwanake	Kahwanake	___	___
      1 Kaartokallio	Kaartokallio	___	___
      1 Kaaresuvanto	Kaaresuvanto	___	___
      1 KYEHTI	KYEHTI	___	___
      1 KULTTUURLUOKKA	KULTTUURLUOKKA	___	___
      1 KIRJE	KIRJE	___	___
      1 KIELÂAŠIJČÄLLEE	KIELÂAŠIJČÄLLEE	___	___
      1 Jåågar	Jåågar	___	___
      1 Jávrebiekkat	Jávrebiekkat	___	___
      1 JÂ	JÂ	___	___
      1 Jyväskylästäst	Jyväskylästäst	___	___
      1 Juvduujuv	Juvduujuv	___	___
      1 Juulev-	Juulev-	___	___
      1 Juoksáhkká	Juoksáhkká	___	___
      1 Junnást	Junnást	___	___
      1 Julgáštusâi	Julgáštusâi	___	___
      1 Jouna	Jouna	___	___
      1 Joonas	Joonas	___	___
      1 Jolanda	Jolanda	___	___
      1 Jokkmokist	Jokkmokist	___	___
      1 Joikun	Joikun	___	___
      1 Joikukotsamost	Joikukotsamost	___	___
      1 Joikukotsamo	Joikukotsamo	___	___
      1 Johkamohkki	Johkamohkki	___	___
      1 Jieŋŋâlis	Jieŋŋâlis	___	___
      1 Jere	Jere	___	___
      1 Jeliseevna	Jeliseevna	___	___
      1 Janrik	Janrik	___	___
      1 Janakkala	Janakkala	___	___
      1 JUÁTKÁM	JUÁTKÁM	___	___
      1 JAMES	JAMES	___	___
      1 IŠEDEIJEE	IŠEDEIJEE	___	___
      1 Irdon	Irdon	___	___
      1 InterregSápmi	InterregSápmi	___	___
      1 Instruction	Instruction	___	___
      1 Innola	Innola	___	___
      1 Ingasofia	Ingasofia	___	___
      1 Info-tv	Info-tv	___	___
      1 Indigenous	Indigenous	___	___
      1 Inarintie	Inarintie	___	___
      1 Inarinsämikielâ	Inarinsämikielâ	___	___
      1 Ilo-169	Ilo-169	___	___
      1 Ijâtti	Ijâtti	___	___
      1 Iina-Marja	Iina-Marja	___	___
      1 Iina	Iina	___	___
      1 Iežas	Iežas	___	___
      1 Idols-kištodmist	Idols-kištodmist	___	___
      1 INARI	INARI	___	___
      1 Human	Human	___	___
      1 Houseband	Houseband	___	___
      1 Hold	Hold	___	___
      1 Hiäđukocemân	Hiäđukocemân	___	___
      1 Hirvasvuo	Hirvasvuo	___	___
      1 Hirvas-Niillasa	Hirvas-Niillasa	___	___
      1 Hirmâdâsráp	Hirmâdâsráp	___	___
      1 Hillevi	Hillevi	___	___
      1 Hilla-Puolukka	Hilla-Puolukka	___	___
      1 Hilla	Hilla	___	___
      1 Hilbes-juávhust	Hilbes-juávhust	___	___
      1 Hila	Hila	___	___
      1 Hiildán	Hiildán	___	___
      1 Higher	Higher	___	___
      1 Hernández	Hernández	___	___
      1 Hermanni	Hermanni	___	___
      1 Hemavan	Hemavan	___	___
      1 Helssegis	Helssegis	___	___
      1 Helgaast	Helgaast	___	___
      1 Heija	Heija	___	___
      1 Heenan	Heenan	___	___
      1 Hearvaduottar	Hearvaduottar	___	___
      1 Heaikka	Heaikka	___	___
      1 Hans-Aandi	Hans-Aandi	___	___
      1 Haldâttâsneuvos	Haldâttâsneuvos	___	___
      1 Hakovirta	Hakovirta	___	___
      1 HELSIG	HELSIG	___	___
      1 HE.	HE.	___	___
      1 Gáktenieiddat	Gáktenieiddat	___	___
      1 Gáivuotna	Gáivuotna	___	___
      1 Guovdageaidnu	Guovdageaidnu	___	___
      1 Gubernator	Gubernator	___	___
      1 Gsm	Gsm	___	___
      1 Gos	Gos	___	___
      1 González	González	___	___
      1 Gollegiellan	Gollegiellan	___	___
      1 Gollegiella	Gollegiella	___	___
      1 Gollegielagat	Gollegielagat	___	___
      1 Gloobaal	Gloobaal	___	___
      1 Giellavealggut	Giellavealggut	___	___
      1 Giellagááldu	Giellagááldu	___	___
      1 Giellagáldu	Giellagáldu	___	___
      1 Giellagas-Instituut	Giellagas-Instituut	___	___
      1 Giela	Giela	___	___
      1 Giehtaruohttasa	Giehtaruohttasa	___	___
      1 Generaliast	Generaliast	___	___
      1 Gallaast	Gallaast	___	___
      1 Galddázat-juávhust	Galddázat-juávhust	___	___
      1 GC/11	GC/11	___	___
      1 GALLA	GALLA	___	___
      1 FÁÁRUN	FÁÁRUN	___	___
      1 Fossekallen-	Fossekallen-	___	___
      1 Fossekallen	Fossekallen	___	___
      1 Formaatij	Formaatij	___	___
      1 Flyygel	Flyygel	___	___
      1 Fiia	Fiia	___	___
      1 Felgen	Felgen	___	___
      1 Fato-	Fato-	___	___
      1 Faabelit	Faabelit	___	___
      1 FINNIM	FINNIM	___	___
      1 Executive	Executive	___	___
      1 Evvan	Evvan	___	___
      1 EvaŋğeŠlium	EvaŋğeŠlium	___	___
      1 Evaŋgellâš-luterilâš	Evaŋgellâš-luterilâš	___	___
      1 Evankelis-luterilii	Evankelis-luterilii	___	___
      1 Euroviisuin	Euroviisuin	___	___
      1 Europarlamiänttár	Europarlamiänttár	___	___
      1 Etnosoi	Etnosoi	___	___
      1 Essi	Essi	___	___
      1 Escamez	Escamez	___	___
      1 Ervast	Ervast	___	___
      1 Erkka	Erkka	___	___
      1 Eljas	Eljas	___	___
      1 Education	Education	___	___
      1 Earrings	Earrings	___	___
      1 EUROD	EUROD	___	___
      1 EU-Komissiost	EU-Komissiost	___	___
      1 Duo-dji	Duo-dji	___	___
      1 Dollagáddist	Dollagáddist	___	___
      1 Dollagáddi-salist	Dollagáddi-salist	___	___
      1 Dollagáddi	Dollagáddi	___	___
      1 Dolla-auditoriost	Dolla-auditoriost	___	___
      1 Dolla-auditorio	Dolla-auditorio	___	___
      1 Dolla-Salist	Dolla-Salist	___	___
      1 Doaivut	Doaivut	___	___
      1 Doahkki	Doahkki	___	___
      1 Divttasvuotna	Divttasvuotna	___	___
      1 Dimension	Dimension	___	___
      1 Dierpmis	Dierpmis	___	___
      1 Declaration	Declaration	___	___
      1 Deatnu	Deatnu	___	___
      1 Davvi	Davvi	___	___
      1 DVD:h	DVD:h	___	___
      1 DOLLAGADDI-SALI	DOLLAGADDI-SALI	___	___
      1 DOLLA	DOLLA	___	___
      1 Cáhppes	Cáhppes	___	___
      1 Culture	Culture	___	___
      1 Corp	Corp	___	___
      1 Cop-12	Cop-12	___	___
      1 Colors	Colors	___	___
      1 Chef	Chef	___	___
      1 COP9-	COP9-	___	___
      1 COP11-siijđoh	COP11-siijđoh	___	___
      1 CO10	CO10	___	___
      1 CD:h	CD:h	___	___
      1 CD-já	CD-já	___	___
      1 Bändijn	Bändijn	___	___
      1 Bánnan	Bánnan	___	___
      1 Bánna-párnái	Bánna-párnái	___	___
      1 Bánna-ohjelmijd	Bánna-ohjelmijd	___	___
      1 Bánna-ohjelm	Bánna-ohjelm	___	___
      1 Bánna-	Bánna-	___	___
      1 Buot	Buot	___	___
      1 Buoidagat	Buoidagat	___	___
      1 Bulla	Bulla	___	___
      1 Bräysyn	Bräysyn	___	___
      1 Brother	Brother	___	___
      1 Briceđost	Briceđost	___	___
      1 Borga	Borga	___	___
      1 Biskop	Biskop	___	___
      1 Birit-Kirsti	Birit-Kirsti	___	___
      1 Birit-Anni	Birit-Anni	___	___
      1 Birasdiehtu	Birasdiehtu	___	___
      1 Biodome	Biodome	___	___
      1 Bikka	Bikka	___	___
      1 Bihcabáhcatmeahcis	Bihcabáhcatmeahcis	___	___
      1 Big	Big	___	___
      1 Biennaalist	Biennaalist	___	___
      1 Bieggagállis	Bieggagállis	___	___
      1 Biegga-almmái	Biegga-almmái	___	___
      1 Beatriz	Beatriz	___	___
      1 Bealljecinat	Bealljecinat	___	___
      1 Bareents	Bareents	___	___
      1 Band	Band	___	___
      1 Baareents	Baareents	___	___
      1 Asâttâsvuáđusâš	Asâttâsvuáđusâš	___	___
      1 Astoäägi	Astoäägi	___	___
      1 Ashtonáin	Ashtonáin	___	___
      1 Arvi	Arvi	___	___
      1 Article	Article	___	___
      1 Artemjeff	Artemjeff	___	___
      1 Arkkitehtuurkištodem	Arkkitehtuurkištodem	___	___
      1 Arkadiankatu	Arkadiankatu	___	___
      1 Arjava	Arjava	___	___
      1 Anniina	Anniina	___	___
      1 Anka	Anka	___	___
      1 Animaatiofiilmah	Animaatiofiilmah	___	___
      1 Andrejevna	Andrejevna	___	___
      1 Anar	Anar	___	___
      1 Amok-kaččâm	Amok-kaččâm	___	___
      1 Ambassaadâr	Ambassaadâr	___	___
      1 Alpensia	Alpensia	___	___
      1 Almostittemrijjâ	Almostittemrijjâ	___	___
      1 Algâalgâst	Algâalgâst	___	___
      1 Algâaalmugjulgáštus	Algâaalmugjulgáštus	___	___
      1 Alexis	Alexis	___	___
      1 Aldamáttááttâš	Aldamáttááttâš	___	___
      1 Alakorva	Alakorva	___	___
      1 Akvé:Kon	Akvé:Kon	___	___
      1 Akustilâš	Akustilâš	___	___
      1 Aku	Aku	___	___
      1 Aitârpargee	Aitârpargee	___	___
      1 Aila-duo	Aila-duo	___	___
      1 Ahlakorpi	Ahlakorpi	___	___
      1 Ad-Hoc	Ad-Hoc	___	___
      1 Aasâmpirrâsist	Aasâmpirrâsist	___	___
      1 Aaro-Juhana	Aaro-Juhana	___	___
      1 Aamnâstijn	Aamnâstijn	___	___
      1 Aalmugijkoskâšii	Aalmugijkoskâšii	___	___
      1 Aabbâs	Aabbâs	___	___
      1 AV-TEKNIKKÁREH	AV-TEKNIKKÁREH	___	___
      1 ARÂŠODDÂDEM	ARÂŠODDÂDEM	___	___
      1 ARTISTVISTE	ARTISTVISTE	___	___
      1 ANAYA	ANAYA	___	___
      1 AARGÂ	AARGÂ	___	___
      1 A2-stuárusii	A2-stuárusii	___	___
      1 8j)-pargojuávkun	8j)-pargojuávkun	___	___
      1 773_7762_+358_50_5242109_+47_78_47_40_00	773_7762_	___	___
      1 70-ivváášjuhleive	70-ivváášjuhleive	___	___
      1 672,00€	672,00€	___	___
      1 4-9lk	4-9lk	___	___
      1 3102/juha.guttorm@samediggi.fi	3102/juha.guttorm@samediggi.fi	___	___
      1 2=Násti	2=Násti	___	___
      1 2000-lovo.	2000-lovo.	___	___
      1 1=Silba	1=Silba	___	___
      1 17-sijđosâš	17-sijđosâš	___	___
      1 1-3lk	1-3lk	___	___
      1 1+2	1	___	___
      1 -‐ravvuuh	-‐ravvuuh	___	___
      1 -‐ravvuid	-‐ravvuid	___	___
      1 *_298	*_298	___	___
      1 **	**	___	___
