Jáákuš+N+Prop+Sg+Nom	Jáákuš

Jáákuš+N+Prop+Sg+Gen	Jákuu	Jáákkuu

Jáákuš+N+Prop+Sg+Acc	Jákuu	Jáákkuu

Jáákuš+N+Prop+Sg+Com	Jákuin	Jáákkoin

Jáákuš+N+Prop+Sg+Ill	Jákužân

Jáákuš+N+Prop+Sg+Abe	Jákuuttáá	Jákuttáá

Čilzeppelaalaaš+N+Prop+Sg+Nom	Čilzeppelaalaaš

Čilzeppelaalaaš+N+Prop+Sg+Gen	Čilzeppelaalaa

Čilzeppelaalaaš+N+Prop+Sg+Acc	Čilzeppelaalaa

Čilzeppelaalaaš+N+Prop+Sg+Com	Čilzeppelaalain		Čilzeppelaalaain

Čilzeppelaalaaš+N+Prop+Sg+Ill	Čilzeppelaalažân	Čilzeppelalažân
Čilzeppelaalaaš+N+Prop+Sg+Ill	Čilzeppelaalaažân	Err/Orth

Čilzeppelaalaaš+N+Prop+Sg+Abe	Čilzeppelaalaattáá

Käldeelááduš+N+Prop+Sg+Nom	Käldeelááduš

Käldeelááduš+N+Prop+Sg+Gen	Käldeeladduu

Käldeelááduš+N+Prop+Sg+Acc	Käldeeládduu	#boastut

Käldeelááduš+N+Prop+Sg+Com	Käldeeladduin

Käldeelááduš+N+Prop+Sg+Ill	Käldeeladduužân

Käldeelááduš+N+Prop+Sg+Abe	Käldeeladduuttáá

Šaldomsuolluš+N+Prop+Sg+Nom	Šaldomsuolluš

Šaldomsuolluš+N+Prop+Sg+Gen	Šaldomsuolluu

Šaldomsuolluš+N+Prop+Sg+Acc	Šaldomsuolluu

Šaldomsuolluš+N+Prop+Sg+Com	Šaldomsuolluin

Šaldomsuolluš+N+Prop+Sg+Ill	Šaldomsuollužân	# boastut
Šaldomsuolluš+N+Prop+Sg+Ill	Šaldomsuolluužân

Šaldomsuolluš+N+Prop+Sg+Abe	Šaldomsuolluuttáá

Káávcáš+N+Prop+Sg+Nom	Káávcáš

Káávcáš+N+Prop+Sg+Gen	Kávccáá

Káávcáš+N+Prop+Sg+Acc	Kávccáá

Káávcáš+N+Prop+Sg+Com	Kávccáin

Káávcáš+N+Prop+Sg+Ill	Kávcážân

Káávcáš+N+Prop+Sg+Abe	Kávccááttáá

Kimessiälgáš+N+Prop+Sg+Nom	Kimessiälgáš

Kimessiälgáš+N+Prop+Sg+Gen	Kimessiälgáá

Kimessiälgáš+N+Prop+Sg+Acc	Kimessiälgáá

Kimessiälgáš+N+Prop+Sg+Com	Kimessiälgáin

Kimessiälgáš+N+Prop+Sg+Ill	Kimessiälgážân

Kimessiälgáš+N+Prop+Sg+Abe	Kimessiälgááttáá

Repšsáágáš+N+Prop+Sg+Nom	Repšsáágáš

Repšsáágáš+N+Prop+Sg+Gen	Repšsággáá

Repšsáágáš+N+Prop+Sg+Acc	Repšsággáá

Repšsáágáš+N+Prop+Sg+Com	Repšsággáin

Repšsáágáš+N+Prop+Sg+Ill	Repšságážân

Repšsáágáš+N+Prop+Sg+Abe	Repšsággááttáá

Suáluičuálmáš+N+Prop+Sg+Nom	Suáluičuálmáš

Suáluičuálmáš+N+Prop+Sg+Gen	Suáluičuálmáá

Suáluičuálmáš+N+Prop+Sg+Acc	Suáluičuálmáá

Suáluičuálmáš+N+Prop+Sg+Com	Suáluičuálmáin

Suáluičuálmáš+N+Prop+Sg+Ill	Suáluičuálmážân

Suáluičuálmáš+N+Prop+Sg+Abe	Suáluičuálmááttáá

Käldeejáávráš+N+Prop+Sg+Nom	Käldeejáávráš

Käldeejáávráš+N+Prop+Sg+Gen	Käldeejávráá

Käldeejáávráš+N+Prop+Sg+Acc	Käldeejávráá

Käldeejáávráš+N+Prop+Sg+Com	Käldeejávráin

Käldeejáávráš+N+Prop+Sg+Ill	Käldeejávrážân

Käldeejáávráš+N+Prop+Sg+Abe	Käldeejávrááttáá

Uccâláássáš+N+Prop+Sg+Nom	Uccâláássáš	# Maiddái: láásáš nominatiivvas

Uccâláássáš+N+Prop+Sg+Gen	Uccâlássáá

Uccâláássáš+N+Prop+Sg+Acc	Uccâlássáá

Uccâláássáš+N+Prop+Sg+Com	Uccâlássáin

Uccâláássáš+N+Prop+Sg+Ill	Uccâlássážân	# boastut
Uccâláássáš+N+Prop+Sg+Ill	Uccâlássáážân

Uccâláássáš+N+Prop+Sg+Abe	Uccâlássááttáá

Áhu-uáiváš+N+Prop+Sg+Nom	Áhu-uáivâš	# Err/Orth
Áhu-uáiváš+N+Prop+Sg+Nom	Áhu-uáiváš

Áhu-uáiváš+N+Prop+Sg+Gen	Áhu-uáiváá

Áhu-uáiváš+N+Prop+Sg+Acc	Áhu-uáiváá

Áhu-uáiváš+N+Prop+Sg+Com	Áhu-uáiváin

Áhu-uáiváš+N+Prop+Sg+Ill	Áhu-uáivážân

Áhu-uáiváš+N+Prop+Sg+Abe	Áhu-uáivááttáá

Sairujuuvâš+N+Prop+Sg+Nom	Sairujuuvâš

Sairujuuvâš+N+Prop+Sg+Gen	Sairujuvvii

Sairujuuvâš+N+Prop+Sg+Acc	Sairujuvvii

Sairujuuvâš+N+Prop+Sg+Com	Sairujuvvijn

Sairujuuvâš+N+Prop+Sg+Ill	Sairujuvâžân

Sairujuuvâš+N+Prop+Sg+Abe	Sairujuvvijttáá

Čullááš+N+Prop+Sg+Nom	Čullááš

Čullááš+N+Prop+Sg+Gen	Čulláá

Čullááš+N+Prop+Sg+Acc	Čulláá

Čullááš+N+Prop+Sg+Com	Čulláin

Čullááš+N+Prop+Sg+Ill	Čullážân	Čulážân
Čullááš+N+Prop+Sg+Ill	Čulláážân # Err/orth

Čullááš+N+Prop+Sg+Abe	Čullááttáá

Suárvvuámááš+N+Prop+Sg+Nom	Suárvvuámááš

Suárvvuámááš+N+Prop+Sg+Gen	Suárvvuámáá

Suárvvuámááš+N+Prop+Sg+Acc	Suárvvuámáá

Suárvvuámááš+N+Prop+Sg+Com	Suárvvuámáin

Suárvvuámááš+N+Prop+Sg+Ill	Suárvvuámážân

Suárvvuámááš+N+Prop+Sg+Abe	Suárvvuámááttáá

Källeeváárááš+N+Prop+Sg+Nom	Källeeváárááš

Källeeváárááš+N+Prop+Sg+Gen	Källeevááráá

Källeeváárááš+N+Prop+Sg+Acc	Källeevááráá

Källeeváárááš+N+Prop+Sg+Com	Källeeváráin

Källeeváárááš+N+Prop+Sg+Ill	Källeevárážân

Källeeváárááš+N+Prop+Sg+Abe	Källeeváárááttáá

Puškoruávjuvvááš+N+Prop+Sg+Nom	Puškoruávjuvvááš

Puškoruávjuvvááš+N+Prop+Sg+Gen	Puškoruávjuvváá

Puškoruávjuvvááš+N+Prop+Sg+Acc	Puškoruávjuvváá

Puškoruávjuvvááš+N+Prop+Sg+Com	Puškoruávjuvváin

Puškoruávjuvvááš+N+Prop+Sg+Ill	Puškoruávjuvvážân
Puškoruávjuvvááš+N+Prop+Sg+Ill	Puškoruávjuvváážân

Puškoruávjuvvááš+N+Prop+Sg+Abe	Puškoruávjuvvááttáá

Uccnjaargâš+N+Prop+Sg+Nom	Uccnjaargâš

Uccnjaargâš+N+Prop+Sg+Gen	Uccnjargii

Uccnjaargâš+N+Prop+Sg+Acc	Uccnjargii

Uccnjaargâš+N+Prop+Sg+Com	Uccnjargijn

Uccnjaargâš+N+Prop+Sg+Ill	Uccnjargâžân

Uccnjaargâš+N+Prop+Sg+Abe	Uccnjargijttáá

Supevuonâš+N+Prop+Sg+Nom	Supevuonâš

Supevuonâš+N+Prop+Sg+Gen	Supevuonii

Supevuonâš+N+Prop+Sg+Acc	Supevuonii

Supevuonâš+N+Prop+Sg+Com	Supevuonijn

Supevuonâš+N+Prop+Sg+Ill	Supevuonâžân

Supevuonâš+N+Prop+Sg+Abe	Supevuonijttáá

Čuárvilakkluovtâš+N+Prop+Sg+Nom	Čuárvilakkluovtâš

Čuárvilakkluovtâš+N+Prop+Sg+Gen	Čuárvilakkluovttii

Čuárvilakkluovtâš+N+Prop+Sg+Acc	Čuárvilakkluovttii

Čuárvilakkluovtâš+N+Prop+Sg+Com	Čuárvilakkluovttijn

Čuárvilakkluovtâš+N+Prop+Sg+Ill	Čuárvilakkluovtâžân

Čuárvilakkluovtâš+N+Prop+Sg+Abe	Čuárvilakkluovttijttáá

