ältti	VCCCV
ertti	VCCCV
älšši	VCCCV
rencci	CVCCCV
toncci	CVCCCV
pälkki	CVCCCV
cerkki	CVCCCV
purkki	CVCCCV
märkki	CVCCCV
tevkki	CVCCCV
lävkki	CVCCCV
pävkki	CVCCCV
paŋkki	CVCCCV
taŋkki	CVCCCV
miŋkki	CVCCCV
muŋkki	CVCCCV
puŋkki	CVCCCV
tuŋkki	CVCCCV
ramppi	CVCCCV
kumppi	CVCCCV
karppi	CVCCCV
nirppi	CVCCCV
sirppi	CVCCCV
värppi	CVCCCV
kävppi	CVCCCV
romssi	CVCCCV
pörssi	CVCCCV
filtti	CVCCCV
hältti	CVCCCV
sältti	CVCCCV
sentti	CVCCCV
tontti	CVCCCV
kortti	CVCCCV
tortti	CVCCCV
pärtti	CVCCCV
šnärkki	CCVCCCV
stälppi	CCVCCCV
spektri	CCVCCCV
pronssi	CCVCCCV
šlantti	CCVCCCV
printti	CCVCCCV
skärtti	CCVCCCV
uárnji	VVCCCV
mielkki	CVVCCCV
hyelkki	CVVCCCV
muálkki	CVVCCCV
nievkki	CVVCCCV
tuávkki	CVVCCCV
myeđkki	CVVCCCV
ruáŋkki	CVVCCCV
tuálppi	CVVCCCV
puálčči	CVVCCCV
ruámčči	CVVCCCV
njuálcci	CCVVCCCV
ärbi	VCCV
ergi	VCCV
ävli	VCCV
ävli	VCCV
älni	VCCV
enni	VCCV
evni	VCCV
evri	VCCV
äšši	VCCV
räbbi	CVCCV
kälbi	CVCCV
sälbi	CVCCV
mecci	CVCCV
picci	CVCCV
häcci	CVCCV
mäcci	CVCCV
läddi	CVCCV
mäddi	CVCCV
päddi	CVCCV
räddi	CVCCV
peldi	CVCCV
väldi	CVCCV
kerdi	CVCCV
kärdi	CVCCV
pevdi	CVCCV
hävdi	CVCCV
nävdi	CVCCV
märfi	CVCCV
jeggi	CVCCV
fäggi	CVCCV
päggi	CVCCV
päggi	CVCCV
säggi	CVCCV
pelgi	CVCCV
velgi	CVCCV
särgi	CVCCV
tävgi	CVCCV
keđgi	CVCCV
lähji	CVCCV
pelji	CVCCV
kärji	CVCCV
nähki	CVCCV
jakki	CVCCV
nakki	CVCCV
takki	CVCCV
cekki	CVCCV
hekki	CVCCV
tekki	CVCCV
näkki	CVCCV
päkki	CVCCV
täkki	CVCCV
ketki	CVCCV
mätki	CVCCV
veški	CVCCV
talli	CVCCV
pilli	CVCCV
tulli	CVCCV
välli	CVCCV
kevli	CVCCV
čevli	CVCCV
kovli	CVCCV
nävli	CVCCV
vävli	CVCCV
helmi	CVCCV
välmi	CVCCV
tammi	CVCCV
pommi	CVCCV
termi	CVCCV
lesmi	CVCCV
penni	CVCCV
ränni	CVCCV
terni	CVCCV
pärni	CVCCV
särni	CVCCV
täsni	CVCCV
sävni	CVCCV
čäšni	CVCCV
happi	CVCCV
mappi	CVCCV
luppi	CVCCV
typpi	CVCCV
näppi	CVCCV
säppi	CVCCV
jävri	CVCCV
taksi	CVCCV
vepsi	CVCCV
rypsi	CVCCV
väpsi	CVCCV
hissi	CVCCV
tussi	CVCCV
kässi	CVCCV
rahti	CVCCV
sahti	CVCCV
pähti	CVCCV
tähti	CVCCV
septi	CVCCV
pesti	CVCCV
tatti	CVCCV
hytti	CVCCV
pahvi	CVCCV
selvi	CVCCV
pälvi	CVCCV
tälvi	CVCCV
servi	CVCCV
sorvi	CVCCV
torvi	CVCCV
rovvi	CVCCV
hävvi	CVCCV
repči	CVCCV
läpči	CVCCV
täbđi	CVCCV
čevđi	CVCCV
lävđi	CVCCV
rävđi	CVCCV
rävŋi	CVCCV
läbži	CVCCV
čevži	CVCCV
njäbbi	CCVCCV
stovli	CCVCCV
njävli	CCVCCV
njälmi	CCVCCV
stämni	CCVCCV
skappi	CCVCCV
njetti	CCVCCV
smätti	CCVCCV
skälvi	CCVCCV
nješši	CCVCCV
stressi	CCCVCCV
uábbi	VVCCV
uárji	VVCCV
aarni	VVCCV
eevni	VVCCV
uáksi	VVCCV
uáhti	VVCCV
äitti	VVCCV
uážži	VVCCV
ryebbi	CVVCCV
suábbi	CVVCCV
kyelbi	CVVCCV
vyerbi	CVVCCV
cyecci	CVVCCV
luocci	CVVCCV
cuápci	CVVCCV
kieddi	CVVCCV
muáddi	CVVCCV
suándi	CVVCCV
veerdi	CVVCCV
kyevdi	CVVCCV
lyevdi	CVVCCV
ryevdi	CVVCCV
tyeggi	CVVCCV
čuággi	CVVCCV
čielgi	CVVCCV
jyelgi	CVVCCV
siergi	CVVCCV
viergi	CVVCCV
syergi	CVVCCV
čuáđgi	CVVCCV
tyelji	CVVCCV
myerji	CVVCCV
ryevji	CVVCCV
čuávji	CVVCCV
miekki	CVVCCV
pyekki	CVVCCV
meikki	CVVCCV
päikki	CVVCCV
ruákki	CVVCCV
päiski	CVVCCV
puáski	CVVCCV
mäihli	CVVCCV
tyevli	CVVCCV
vyevli	CVVCCV
suávli	CVVCCV
suávli	CVVCCV
čuálmi	CVVCCV
čuámmi	CVVCCV
jiermi	CVVCCV
viermi	CVVCCV
kyermi	CVVCCV
syermi	CVVCCV
juármi	CVVCCV
syelni	CVVCCV
kiemni	CVVCCV
saarni	CVVCCV
pierni	CVVCCV
tieppi	CVVCCV
kyeppi	CVVCCV
čierri	CVVCCV
mievri	CVVCCV
huávri	CVVCCV
kuálsi	CVVCCV
suálsi	CVVCCV
vyepsi	CVVCCV
kyessi	CVVCCV
lyönti	CVVCCV
lyesti	CVVCCV
vyesti	CVVCCV
nyetti	CVVCCV
säitti	CVVCCV
juutti	CVVCCV
suálvi	CVVCCV
kuárvi	CVVCCV
nuárvi	CVVCCV
suárvi	CVVCCV
čuárvi	CVVCCV
nyevvi	CVVCCV
syevvi	CVVCCV
ruánzi	CVVCCV
syevđi	CVVCCV
juárŋi	CVVCCV
tuávŋi	CVVCCV
huášši	CVVCCV
snyerdi	CCVVCCV
skyelfi	CCVVCCV
njuáski	CCVVCCV
greippi	CCVVCCV
skierri	CCVVCCV
gneissi	CCVVCCV
epi	VCV
peci	CVCV
čäci	CVCV
laki	CVCV
sali	CVCV
tili	CVCV
kumi	CVCV
pöpi	CVCV
tori	CVCV
väri	CVCV
vesi	CVCV
tyvi	CVCV
äigi	VVCV
ääji	VVCV
uáli	VVCV
ääli	VVCV
eemi	VVCV
ääpi	VVCV
aari	VVCV
uári	VVCV
aasi	VVCV
uási	VVCV
eeti	VVCV
eeči	VVCV
äiđi	VVCV
leibi	CVVCV
seibi	CVVCV
käibi	CVVCV
tuubi	CVVCV
peeci	CVVCV
čeeci	CVVCV
čääci	CVVCV
veigi	CVVCV
läigi	CVVCV
räigi	CVVCV
täigi	CVVCV
vyehi	CVVCV
čyehi	CVVCV
cuáhi	CVVCV
kuáhi	CVVCV
suáhi	CVVCV
leeji	CVVCV
syeji	CVVCV
tyeji	CVVCV
rääji	CVVCV
kaali	CVVCV
šaali	CVVCV
keeli	CVVCV
meeli	CVVCV
peeli	CVVCV
teeli	CVVCV
kyeli	CVVCV
vyeli	CVVCV
rooli	CVVCV
vuoli	CVVCV
tuáli	CVVCV
čuáli	CVVCV
määli	CVVCV
nääli	CVVCV
raami	CVVCV
seemi	CVVCV
kyemi	CVVCV
vyemi	CVVCV
käimi	CVVCV
näimi	CVVCV
luámi	CVVCV
häämi	CVVCV
näämi	CVVCV
säämi	CVVCV
geeni	CVVCV
meini	CVVCV
seini	CVVCV
viini	CVVCV
kääni	CVVCV
lääni	CVVCV
pääni	CVVCV
sääni	CVVCV
lyepi	CVVCV
nääpi	CVVCV
tääpi	CVVCV
baari	CVVCV
teeri	CVVCV
nyeri	CVVCV
pyeri	CVVCV
koori	CVVCV
duuri	CVVCV
kuuri	CVVCV
suuri	CVVCV
muári	CVVCV
kääri	CVVCV
vääri	CVVCV
kaasi	CVVCV
keesi	CVVCV
vyesi	CVVCV
riisi	CVVCV
köysi	CVVCV
rääsi	CVVCV
tääsi	CVVCV
neeti	CVVCV
čyeti	CVVCV
muoti	CVVCV
kuáti	CVVCV
suáti	CVVCV
pääti	CVVCV
haavi	CVVCV
paavi	CVVCV
lyevi	CVVCV
peivi	CVVCV
väivi	CVVCV
häävi	CVVCV
keeči	CVVCV
leeđi	CVVCV
päiđi	CVVCV
räiđi	CVVCV
säiđi	CVVCV
ruáđi	CVVCV
rääđi	CVVCV
njäidi	CCVVCV
njäähi	CCVVCV
stääli	CCVVCV
snyeri	CCVVCV
njuári	CCVVCV
skäiđi	CCVVCV
sieidi	CVVVCV
pyeidi	CVVVCV
nuáidi	CVVVCV
kyeimi	CVVVCV
čyeimi	CVVVCV
syeini	CVVVCV
